kris805	christina	female
SNDRMRTSB	sandra	female
coleneiers	cole	male
PorscheofSports	patrick	male
DavidInnerb	david	male
jdefarias12	juliana	female
YaBoyAlford	darius	male
8d0e6cc7ec49452	wendy	female
rilandersonn	riley	male
b_piepenbrok	bryan	male
sleepystupid	mel	male
dlflygrl	maria	female
slo102	sarah	female
geeztoddy	todd	male
Brodes81	hunter	male
AnthonyJBarton	anthony	male
hannahlawler56	hannah	female
morrrgs__	morgan	male
jclarkcni	john	male
lrhfthaley	luke	male
nicely_melissa	melissa	female
cookiecolelu	cole	male
BobKelleher	bob	male
bridgettcriss	bridgett	female
Roqn93	robert	male
Yountman	randy	male
dwest9cubs	david	male
Jmouderkerken	jacob	male
LordTatters	eric	male
teejayelle_	taylor	male
NateSchalt15	nathan	male
JacoboDaHobo	erik	male
Alleycat34Lee	allison	female
jessicaa__leigh	jessica	female
scanElee	sarah	female
EBrogden98	elizabeth	female
Juliemuaa	juliana	female
megantayla	megan	female
DrewHaninger	drew	male
janelleruiz	janelle	female
SophiaRahming1	sophia	female
StephanieRabago	stephanie	female
MarilynBricka	marilyn	female
Ana_Silvia8	ana	female
propaintingco	carlos	male
calacas12	roberto	male
EASJR1991	ellis	male
dolly2valeria	julia	female
tqbf	thomas	male
5sosaf96	luke	male
KyleAbbot	kyle	male
Pablo_Tavon	pablo	male
hizzults	chelsea	female
andlin	andrew	male
normalnash	chad	male
AKOrtiz	alexandra	female
RachelMeemken	rachel	female
Cleatus_Live	anne	female
CarterKilfoy	carter	male
emdalbero	queen	female
Captiann_Morgan	morgan	male
biticonjustine	justine	female
BriannaChavezzz	brianna	female
mgoforth10	mason	male
betteroffbetter	vanessa	female
BetoMetroDos	robert	male
caitlinraenaldo	caitlin	female
BrookeMaglish	brooke	female
N_WiNCHEL	nick	male
tutorindie	mike	male
_laurenpatruno	larry	male
LizGreenspan1	liz	female
Nash_dabae_	chad	male
phillygib	phillip	male
DaveGags12	dave	male
daphnevartist	daphne	female
colesebas	cole	male
annakoryto	anna	female
sellinglikemad	beth	female
alexis_presti	joyce	female
meganobrien198	megan	female
elyiyorock	juan	male
jmanmetsfan1	jason	male
sxoidmal	christian	male
mudcelt	virginia	female
CarlosCarralH	carlos	male
michelle0xx	michelle	female
lakeloonatic	alan	male
KSU_Career_Svcs	kent	male
seancarlson	sean	male
Dare_PhD	diego	male
teenagelesley	lesley	female
Ryan_Rojas_	ryan	male
morinap	andrew	male
steezydc	david	male
nathanzak138	nathan	male
Track_grease	anthony	male
xoxotp	tina	female
Mnmcnelly	megan	female
76coug	jim	male
braves52	brad	male
SteveBurtch	stephen	male
jessikamazinggg	jess	male
Matt_DiFilippo	matt	male
_lexkill22	alexandra	female
fvckbillie	billie	female
Claytonbryant38	clayton	male
irishstranglrOC	matt	male
Jarrrvis	margaret	female
DanielleAlex1D	danielle	female
xoxoxrachael	rachael	female
_espiee	esperanza	female
sa_raaahh	sarah	female
joeycamasta	joey	male
ahoov94	andrea	female
eriks	erik	male
anothersick	anne	female
Teri_Lynn	teri	female
AceDave27	david	male
EmUhLeeO	emily	female
smokinJAYS_	april	female
ashley__velasco	ashley	female
bhoff2008	brandon	male
tomgreene2	tom	male
snb_21	sarah	female
TheRealDoubleMs	marcus	male
AdamDannyDaniel	adam	male
tamarataylorma	tamara	female
veronicaiam	veronica	female
thepoisedlife	tim	male
SBrown342	sarah	female
PhilBevinsRiley	riley	male
lizzoebobizzoe	lizzie	female
KatelynJessmon	kate	female
Jasindn	jason	male
MikeThePasquale	michael	male
bullsfan_av	adrian	male
LovinqqJahari	sandy	female
EseZurdo_11	angel	male
tay_mazz5	taylor	male
beausimensen	beau	male
OneBalanceWiz	tanner	male
Jenifer_Cho	jenifer	female
AaronStarmer	aaron	male
ItsOnlyToniTech	toni	female
InezPardo	inez	female
brixgnz	leslie	female
banaaa_	shana	female
nathanwentworth	nathan	male
KFink61	kevin	male
angel_j_rivera	angel	male
breonna_xo	queen	female
AlexxxxNicole23	al	male
shelbyypio	shelby	female
EllensStories	ellen	female
whytexyz	wayne	male
JohnAllisonPub	john	male
alaaw_alshamali	ali	male
lngiaccio	lauren	female
Mallement	nicole	female
eva_janine	eva	female
JiggySpvcxly	pete	male
JakeHManning	frank	male
_11Sleek	james	male
twilson348	tom	male
aveeeryy	avery	male
sheree94547514	sheree	female
rae99	rebecca	female
damnitsdonald	donald	male
frostyfridge	thomas	male
segadofr	fran	female
TheNerd831	yesenia	female
HeyItsMDouv	michelle	female
SimonMarksFSN	simon	male
GarrettPainter7	garrett	male
1973Jroconnor	janet	female
ItsSarah3	sarah	female
fakemikemulloy	mike	male
Johntucker990	john	male
BlackVeilKat	kathryn	female
KamsInNOut	alejandra	female
TravisMazna	travis	male
JLuizza	jerry	male
BethanyHelzer	bethany	female
Brandon_Carrico	brandon	male
scottholstad	scott	male
LindseyMarieJ__	lindsey	female
DudeistBelieve	nicholas	male
HannahAlonzo511	hannah	female
RealLauraOwen	laura	female
Kayhla_Aranay	kay	female
DaisyDanielle3	danielle	female
Ashel_Wells	ashley	female
supergolfdude	ed	male
Judith4AU	judith	female
stephen_szy	stephen	male
drough_	pedro	male
Mr_C_Wells	christopher	male
docnolz	shane	male
CallaghanPeter	peter	male
Yuh_Arty_Know	marty	male
okkocaoglu	nick	male
chelseakatt	chelsea	female
haydenth	tom	male
DonZurek1	don	male
cofphoto	shawn	male
isabellav1099	isabella	female
smass1525	stephanie	female
BroThatsDanni	dan	male
lanavas46	lana	female
docmurdock	michael	male
craigtimes	craig	male
JohannaBSellman	johanna	female
danielson209	daniel	male
ptednes	patrick	male
chris_journo	chris	male
DerekMacEwen	derek	male
randibruce0	randi	female
NSooto	nick	male
canoluzhero	jose	male
cockdog03	kasey	female
nryan_ss	nikki	female
LuigiOfTheRock	louis	male
ryanmoore	ryan	male
DelilahSnow	alana	female
Saehrler	stephanie	female
Marlon_199321	marlon	male
MusicAdamT	adam	male
OMFGITSOSCAR	oscar	male
alexdeleonn	alexandra	female
RossMaxwellWAPL	ross	male
hannah_sierra	hannah	female
Brendan_Fehmie	brendan	male
jdubrule	jeff	male
MoDaCoatLFPress	morris	male
sassybbhgirl	christine	female
PaigeFursman	paige	female
CyborgAbreu	roberto	male
JustinBlank16	justin	male
DamionMMartinez	damion	male
isysmom	kristin	female
Its_Dess_Bitch	queen	female
allisontaylor55	allison	female
alexbarch112	alex	male
houserandy	randy	male
bigpicresults	christian	male
dbgossett	darrell	male
fatboii_DH	alex	male
ScottCastanon	scott	male
avalon304	richard	male
lauraneckstein	laura	female
Alaysiarox2	chad	male
tyrheaume	ty	male
TrentB_G3	trent	male
adhdana15	dana	female
Ammooo_xox	amber	female
kirst_little	kirsten	female
chelsaway	chelsea	female
matthewrreis	matthew	male
Jmcobern1	jim	male
isabeljenna	jenna	female
colintrafferty	colin	male
xoxArham	queen	female
tedfoth	ted	male
DorkDyke17	victoria	female
HiDeHo22	heidi	female
JeremyAlicandri	jeremy	male
hi_im_asiann	jenna	female
jaaannniiie	janie	female
gabxtch	gabriel	male
mattsm00th	matthew	male
JudithAnnDe	judith	female
mknepprath	michael	male
_jillianrosee	jill	female
_KD7DDY	kyle	male
torrrrreschris	chris	male
jtrainor0125	jim	male
TonyPaz	tony	male
ThaREALStritz	benjamin	male
albuquerquekid4	charlie	male
AlissaMitchell_	alissa	female
ChaarlieeM	charles	male
bpattts	brian	male
ashleyykimm	ashley	female
jw_andersonjr	james	male
jasmineasmith__	jasmine	female
xmeganclairex	megan	female
Kimmyfreckles	kim	female
JustinColeGIS	justin	male
ruby_delarosa	ruby	female
eh_its_axel114	alex	male
liljamal694	anthony	male
DaviDeLoney	david	male
shanndalton	shannon	female
yo_dom44	dominic	male
kelseydavis04	kelsey	female
princess_andy7	andrea	female
JenniTidd	jennifer	female
87c61cb92f29466	maria	female
emilyalane33	emily	female
brewmasteresq	tom	male
CaptainM0rgan_	morgan	male
Rach_mcmahon3	rachel	female
superstar_beat	robin	female
anaisbover95	aldo	male
anna_albus1	anna	female
buetowful	jordan	male
dianakayloesch	diana	female
shanalynen	shana	female
brooksie_47	molly	female
TLockette_Star	tim	male
Joe_Meinert6	joe	male
michaelgass	michael	male
ArielRoland95	ariel	male
faithbobillooo	faith	female
jd7xx	jennifer	female
Brom_28	ben	male
_ThatBoyEarnest	young	male
liv_dixon_	olivia	female
jgonzalez11_	jesse	male
marisakmilkyway	marisa	female
mayraa_xox	mayra	female
adrianbrivera	rick	male
YevragBelac	caleb	male
RachelOBeauty	rachel	female
CbKilla217	chance	male
tatugirl	caroline	female
Gmiranda05	gabriel	male
youngabe10	abe	male
amtant1972	angela	female
BobbiSizemore	bobbi	female
_PomegranateJas	jasmine	female
kennycastrog	kenny	male
j_king941	julia	female
Vita_Rose	jessica	female
soyMariitzaa	maritza	female
tctc1414	taylor	male
bscooper60	scot	male
TylerNolan_2	tyler	male
rmtz_reyes	ricardo	male
muhammadALLIson	allison	female
seagulli0n	lauren	female
TXsoftballvoice	terry	male
CelticAmbler	michael	male
OVOBrendan	brendan	male
ashley_valk	ashley	female
kristianj26	kris	male
Aboundlessworld	bud	male
Caliigirl93	lindsey	female
JMethner	joshua	male
katemattz	kate	female
Qu33nSiz3d	trina	female
LoNF22	lauren	female
antoniofoles	antonio	male
Barvsr	brian	male
katellynmercado	kate	female
beto54381	roberto	male
missashhxo	ashley	female
TH3_HULLK1	cory	male
curseofmight	tyler	male
prjr51	pat	female
LorennWait	loren	male
karen_ramirez98	karen	female
haleymsalinas	hal	male
EricSaub	eric	male
dciskey	dan	male
robgoodwinjr	robert	male
jtjazz1	jasmine	female
hillaryfoster	hillary	female
blakchris415	chris	male
lindsaylacoste	lindsay	female
AlanSemsar	alan	male
AAnnGGeeLLoo_	angelo	male
Robear_toe	robert	male
mykewl95	michael	male
jake_westerman	jake	male
EmilyShonka	emily	female
JoeyThisKidFix	joey	male
jonah_braz	jonah	male
samthesamurai	sam	male
lhollandworth	lynn	female
Emilyhope39	emily	female
mrsF5	amy	female
RiderMajka1996	alexis	female
marciabikinifit	marcia	female
LillieMaeD1	lillie	female
ImChrisReed	chris	male
SamanthaSlz	samantha	female
OGPizzaPirate	stevie	male
harmon_sr	david	male
beewic	troy	male
TimPulliam1	tim	male
txtbks	nicole	female
jujukoo	julie	female
chelsea_laughs	tom	male
_CloutBoii	daniel	male
meshelmay	michelle	female
Pat_Kinch	pat	female
Dan_Soules	danny	male
MinnSportsFreak	bobby	male
westie1951	emma	female
_chuckieB	chuck	male
daphylin	daphne	female
deanne_rose415	deanne	female
ashleysschwartz	ashley	female
Tyler_Yocom	tyler	male
pamelarogel	pamela	female
WintersNFL	ryan	male
__pedrolopez__	pedro	male
ariel_vandusen	ariel	male
allie_paige15	allie	female
jslx0	jennifer	female
uhrinakerry7	kerry	male
din0saurwar	heath	male
MrsMcGuck	mandy	female
CHADnAKRON	chad	male
amanduhpleasee	amanda	female
adieguti	adrienne	female
JesusFcoMeza	jesus	male
ClauEsmahan	claudia	female
bryceless	bryce	male
kylebroyles	april	female
magalliani69	marco	male
pana1173	jose	male
Chuckwood_21	ryan	male
itsjamiesuee	jamie	female
itsvickyy__	victoria	female
JacobPMatthews	jake	male
PressPlayDavid	david	male
TheFonzPart	danny	male
mikeejoe	joe	male
JayGvld_	queen	female
JCarol11	queen	female
stephybennettt	stephanie	female
AndersonnJess	jessica	female
emma_daily1011	emma	female
tweetlyrical	amanda	female
staindoiram	mario	male
_wendyramirezz	wendy	female
Jakelawler42	jake	male
martyistheparty	megan	female
rashel09	raquel	female
SusanMorris6	susan	female
Mass_Daddy44	ethan	male
Justinoursler	justin	male
valeriedipinto	valerie	female
AVargas9715	alana	female
katiewhiskey_	katie	female
dsmontague	duane	male
barra_jen	jenny	female
tanyaa182	tanya	female
_DRXA	andrea	female
Got_sherWOOD	jerry	male
jeffreyt_su	jeff	male
runawayshawn	alyssa	female
TORINODRIVE	jody	female
rln22	rhonda	female
ColeBurks50	cole	male
isaac32767	isaac	male
max5336	max	male
Coach_Reed14	ian	male
jennilicious_x	jennifer	female
ayawnaa	lana	female
Sara_Tonyn	sara	female
Eva_Slims	denis	male
FrcknAbbby	abigail	female
itisibecky	becky	female
whello	joe	male
TheChewDefense	ryan	male
tmgsluv	tiffany	female
AshleyMurrow	ashley	female
kaymars91	kayla	female
learnett	logan	male
scotferdon	scot	male
MbkMentoring	john	male
lindseybc1	lindsey	female
JamesWilsonPL	james	male
TracyNester1	tracy	female
AyeMell	alison	female
imjameshall	james	male
kd0dbo	rick	male
MorganMurphy45	morgan	male
proverbs31_emt	emily	female
kathrynclarkart	kathryn	female
jhernandez0226	jeanette	female
MichaelTacketts	michael	male
AshleySchulner	ashley	female
GunsmithG	garry	male
BillOzanick	bill	male
zanerta	zane	male
nadia_nikole	nadia	female
larryposts11	carmen	female
HelmetGuy33	nick	male
reall_talk	nick	male
timkrepp	tim	male
EdwardRios_	edward	male
_maarriiaa	maria	female
ChristinaLatsko	christina	female
politiCOHEN_	kelly	female
JoshuaDaneger	pete	male
marycattherine	mary	female
3Dannym	danny	male
sstevenson91	sean	male
emeryemeryii	emery	male
DT_Rage	dylan	male
mainelyinspired	maxine	female
nickcouncilor91	nick	male
sam_marzullo	sam	male
F_DollaSign	freddy	male
AnthonyJConklin	anthony	male
MyCatClark	dee	female
veloooooooooooo	nick	male
Amandabnguyen	amanda	female
damoncarter10	damon	male
RogerCanale	roger	male
_taylorrenee_xo	taylor	male
samaanthhhaa	samantha	female
ylrebmiks	kimberly	female
PatryShaun	shaun	male
SausageKing_	joe	male
rachann008	rachel	female
ICutYoLawn_Duhh	yolanda	female
MoniquePatil	monique	female
kattte101	katelyn	female
_alyssa13_	alyssa	female
marystarosa	mary	female
joshc37632990	josh	male
sethinsa	seth	male
sd5277_g	sam	male
moon	paul	male
theBrady	brady	male
pk30030	peter	male
AlexandraBloom	alexandra	female
DreamDelights00	mark	male
dcvet	chris	male
colettebrooks	colette	female
SuzanneNadeau2	suzanne	female
MikeNaraine	mike	male
hannahreevesss	hannah	female
romeronick	nick	male
EddieMontoyaa	eduardo	male
rdsanchezjr	ruben	male
faithhbella	faith	female
emilywolowicz	emily	female
andreeaxo__	andrea	female
kirkFWDSET	kirk	male
mrs__capp	amy	female
KidClutch52	nick	male
TheShamm	connie	female
laurendooley10	lauren	female
TashaEdge21	tasha	female
Msf9	michael	male
cwright_22	colin	male
KMReinhard	katherine	female
SirJoeyClem	joey	male
_BROCKY	ken	male
MiriamHuertas1	miriam	female
SputnikAZ	justin	male
_marinabrady	marina	female
annareilmann	anna	female
M_Walkup	wyatt	male
ronald	ronald	male
ThurmanKilgore	thurman	male
carolineenx3	caroline	female
_emma__nem_	emma	female
mandystlpd	mandy	female
lincolnmullen	lincoln	male
JuFrmDaBAM	julia	female
vallance22	richard	male
EdnaNelsen	edna	female
artologica	michele	female
jordannbolinn	jordan	male
CarolynSessler	carolyn	female
urawizardharry_	lisa	female
carmonadennisea	alex	male
5SOSupdatz	luke	male
KLFStudio	katie	female
marisaburdick	marisa	female
RonnyTooTurnt	ron	male
ShaneSTACKZs	shane	male
phoenixsong16	penny	female
Whit1_215	dennis	male
mcallisterce	claire	female
rooftoptales	andrew	male
GormoJourno	ryan	male
Kate_JustSayin	kate	female
NanaBoo_xD	natasha	female
TinaZucchero	tina	female
egsavard	eric	male
basicmarissa	marissa	female
dbeckner165	dylan	male
shawnraposo	shawn	male
AmberRoseMedina	amber	female
chinonacks	chad	male
jnaranjo21	jeremiah	male
JimDuncan	jim	male
TheJonMartin	jon	male
bambiiixx6	sarah	female
LillieKeenan	lillie	female
HannahTout	hannah	female
Keepers_Union	justin	male
justbeingbeachy	brianna	female
jessicamaes7	jessica	female
FanofDebby_Ryan	queen	female
Pommeofvie	gloria	female
Mattfobrien	matt	male
Lrodyz_23	luis	male
alliccia_2	alicia	female
shgeldz	scott	male
FreddieComedy	freddie	male
BClark87	bryan	male
davidf87	david	male
austinwheeler12	austin	male
dauzatftdillon	tara	female
keby41	kevin	male
YaGuyTy	tyler	male
MaryAnnRusso8	mary	female
Evolve_Native	kyle	male
Sammyillaa01	samantha	female
NateImaWilson	nathan	male
deneenisqueen	emma	female
virelli	tony	male
LordSkipworth	dustin	male
jess_thiel	jessie	female
clengeland1	curt	male
Davethegreatx	david	male
tdugard	todd	male
ughleonor	leo	male
erlkonigkid	marcus	male
Doctor_Ruckus	joe	male
INFINITOANGEL	julio	male
MixesByDarwin	darwin	male
ortizee21ios08	esteban	male
boyleheights13	ivan	male
Sean7Faska	sean	male
audreyann_xx	audrey	female
misshannahhhhh	hannah	female
nick_mitchell96	nick	male
MichaelJuly14	michael	male
jennie2193	jennie	female
celestefrausto	celeste	female
Jesuss_zR	jesus	male
Dan_Cassaro	dan	male
fuzzuzz	matt	male
JamesNeveau	james	male
aglenn95	alex	male
shannonxmaxwel1	shannon	female
louie_argiro	louie	male
ashmehorczyk	ashley	female
JewelzJess	jess	male
grilledsleeze	heidi	female
CoachVoorhis	bruce	male
KSL_SandraYi	sandra	female
smithsr185	sarah	female
luvkaitlynnfaye	kate	female
ClaireExoxo31	claire	female
STDills	don	male
Canelohhh	anthony	male
hannahplaterio	tiffany	female
Just__Jessica_	jess	male
JessicaRovida	jess	male
anvtrademark	ashley	female
ltheiden	lucas	male
lipstickbrenda8	brenda	female
PetersonJenna	jenna	female
dovey2316	maria	female
DemonzAlexandra	alexandra	female
itzginababyy	gina	female
_jDub___	jesus	male
joesobkowiak	joe	male
hopeciappetta_	hope	female
LC_Mitch3096	lauren	female
dollfacevanessa	vanessa	female
Ron_Hutchcraft	ron	male
amhindc	adam	male
PhillyNewsGuy	joshua	male
ByronWJohnson	byron	male
ryangfogle	ryan	male
the_tonyjoe	anthony	male
Deeg_1990	shawn	male
RodriguezIr36	iris	female
Shundria99	chuck	male
porrovecchii	alyssa	female
what_the_KELL7	kelly	female
cedarspills	thomas	male
nicksusi11	nick	male
jennymartin47	jenny	female
emily_dewett	emily	female
suppynatalia	natalia	female
JohnHarvey37	john	male
WSOFMichelle	michelle	female
DrewVogrin	drew	male
LeviRainsss	levi	male
ChiGra85	greg	male
IbdJen	jenna	female
Detcookieman74	arthur	male
emvbisme	liz	female
Raahh__	robbie	male
IsaiahTrickey	isaiah	male
darthdad1701	jason	male
karencaamal	karen	female
mixalych91	mike	male
BrandonSteburg	brandon	male
DawnScurry	dawn	female
bootsy_48	lisa	female
mikereaser	mike	male
erikasunglao	erika	female
Im_L0VING_It	michael	male
rachael_sale	rachael	female
Cali_living02	adrian	male
SmithPamntommy	pamela	female
Katelyn587	katelyn	female
graysonandre__	andre	male
WaitWhatDTD	alex	male
jakejohnson137	jake	male
The_Real_ARat	alex	male
morganhjames	morgan	male
garrett_huntt	garrett	male
alfaphilfa	kenny	male
adanooope	adam	male
gabrieltorrestv	gabriel	male
rosiezavala__	rosie	female
FMR0662	frederick	male
CARLDBIRMAN	carl	male
nealiooooooo6	neal	male
fractenberg	ben	male
taylynnnn__	taylor	male
captonbyrd	justin	male
Abbyduncan35	abby	female
JACK_MY_SwAg081	jack	male
Jesssa02	jess	male
CassieWatt	cassandra	female
erikgampick	erik	male
stephanier577	stephanie	female
CoachDDukes_87	damon	male
Laura_Greyy	laura	female
OvOGregory10	gregory	male
SCBreske	samantha	female
jordan_jimenezz	young	male
slumberdeprived	sabrina	female
missdeelioo	erin	female
gabedsn	gabriel	male
_ImGucciYouPolo	mitch	male
GreaEvan_2016	evan	male
CarlyRose1991	carly	female
sebcampos	sebastian	male
Oh_licious	annie	female
summer_amoia5	summer	female
InSevWeTrust	cody	male
Selena_Mariiexx	selena	female
Ali_navarro14	ali	male
RachelAlbrechtt	rachel	female
SchindlerPhotos	sharon	female
EmmaCaperton_27	emma	female
Aubbbssssss	jerome	male
bubbleteller44	alex	male
madelinejk19	madeline	female
Ryan_MQ	ryan	male
JoseLockerz	jose	male
datrina829	katrina	female
lynn_nich	wanda	female
allisonbreann12	allie	female
RiverCityPauly	paul	male
danwinslow	dan	male
DealsbyDonna	donna	female
urbanberber	queen	female
williamcrowell	william	male
MadelineNooney	madeline	female
Ggee007Gloria	gloria	female
crrevis1990	chelsea	female
amybarto	amy	female
rachel_vigne	rachel	female
Hummel04	levi	male
aliyahmataa	ali	male
robynPRful	robyn	female
get_HOF_me	greg	male
T_Stack_	thomas	male
Warrior_L0vatic	abby	female
DonnaGStewart	donna	female
jvillegas_7	jon	male
AshleyHanrahan	ashley	female
BreanneGnacke	vern	male
andreabenadum	andrea	female
Shmollsss	holly	female
_Cynthia28	cynthia	female
mrryansmif	ryan	male
iSo_Ivyy	andrew	male
Collino24	collin	male
ajturner	andrew	male
mvreuh	maria	female
BLaQuizzy	brittany	female
prenerk	andrew	male
katevanblack	kate	female
reneeletechipia	renee	female
Rachel_Steele32	rachel	female
TeddyMakwa	teddy	male
jewelltreats	jewell	female
wreckLYSS	alyssa	female
nanceeeycb	nancy	female
thesoggiest	david	male
terencewinslow	terence	male
irislaraaa	iris	female
christineklemis	christine	female
Digital_DRK	darryl	male
alexiskayy1	alexis	female
alexisstoico1	adriana	female
_saaandoval	alex	male
GarrisonBlue	jackie	female
WIcHO_JOaKO	joaquin	male
twoplustwoisfiv	ruth	female
kman49	kevin	male
rogeolgu	roger	male
Kungfoolfightin	jessica	female
LoLAguamentius	taylor	male
MollyLudden	molly	female
ESPN_Future	stephen	male
gregrussell23	greg	male
Atom_Murray	adam	male
dianerrs	diana	female
NikkiG159	nicole	female
Sariii_Lag	sarah	female
sebastianbehar	sebastian	male
callieephillips	callie	female
Scubaish	steven	male
BridgetCSchmidt	bridget	female
LittleMorgannn	morgan	male
3Hunnnaaa_	hunter	male
martacrowe	marta	female
TonyMaskevich	tony	male
MiguelDelRa	miguel	male
Kay_Tayfck	katie	female
laurensupr0n	lauren	female
_m_miles	michael	male
comacinema	elvis	male
kshaeeee	kendra	female
marknoonan831	mark	male
RebNicole_2015	rebecca	female
PHEGES	jill	female
mrdavidboberesq	david	male
michellem1206	alex	male
AlexandraColene	allie	female
smparks_mktg	shawn	male
missbriana21	briana	female
megaanwylie	megan	female
clevezirm	jordan	male
alemedina__	alejandra	female
tylerrrm	tyler	male
rachelle013	rachelle	female
juangrimaldo79	juan	male
Pay_Lyss	alyssa	female
SarahCrisman19	sarah	female
koookeith	keith	male
RyGuyAZ	ryan	male
ActualTyKrusch	tyler	male
zubal_	andrew	male
congenial	maurice	male
Copas35	dominick	male
CyrusNoaah	audrey	female
espn4lyf	allen	male
nickminaa	nick	male
TheBrianEarley	brian	male
Heatherr45_	queen	female
audrey1nd	audrey	female
BasedGodCollin	collin	male
SchwabJobs	charles	male
ellamarie425	ella	female
JacobSanchez_	jacob	male
abarrio	angel	male
waded	wade	male
alexhardbarger	alex	male
LaurenDezenski	lauren	female
Urban_Legend252	brian	male
Robbie_CD	robbie	male
MissSharon00	sharon	female
Bmelv101	bryan	male
Fernandeezy1	fernando	male
taylorbuley	taylor	male
_peachykeene	lauren	female
LesMiseration	harold	male
KathyAngel2	kathy	female
defyrecordings	robert	male
BrettRedacted	brett	male
princess_lucyyy	lucy	female
sarahetland	sara	female
hannahslame	hannah	female
CH_AdvantaVape	carrie	female
NatalieVandell	natalie	female
terresabieber	lucy	female
GustavoArmagno	gustavo	male
funangela	angela	female
theKYLERAY	kyle	male
oldgrahammare	rocky	male
kimberlymunsonn	kim	female
AStevenson2014	austin	male
tuukka_	courtney	female
scottleeatlanta	scott	male
wakefieldheidi	heidi	female
karinataylor15	karina	female
CashmereFog	samantha	female
worldclasspapa	ken	male
omgitzlalauren	lauren	female
joannaestep	joanna	female
oobiewpb	marc	male
morganwingo_	morgan	male
NotDevonSupper	devon	male
megankillilea	megan	female
MorganChase22	chase	male
caaamieee	camille	female
ShiftParadigm	mark	male
TheXavierAdames	xavier	male
Versuhtyle	jake	male
RuthClark11	ruth	female
rdew925	robert	male
itsjordantyler	jo	female
ChristianRowden	christian	male
Anthony52Carino	anthony	male
barbarasaucedo	barbara	female
bekaahbae	rebekah	female
SydneyMcCluskey	sydney	male
fussballsusie	susie	female
religiousasfuck	christian	male
KarlTPF	karl	male
UncleSam916	samuel	male
Thatcoolkid817	elizabeth	female
Winger23	tim	male
allison_saigh	allison	female
GRonemus	greg	male
Sseward37	scott	male
PriiShamiiXo	priscilla	female
Ben_BBC	ben	male
clayhuffdawg	clay	male
clarasofiab	clara	female
Josh_Beaupre	joshua	male
imvictoriafratz	victoria	female
katielou_94	katie	female
DianeBMorrison	diane	female
Cphillips_17	casey	male
broglese	mike	male
robert_vining	robert	male
dan_whiteboy	daniel	male
BLifeKaty	katy	female
Nic0le_V	nicole	female
thebryanbreeze	bryan	male
CrucifyyJ	justin	male
froggyfrog119	tony	male
Saralmacdonald	sara	female
boehmcm	christy	female
409SleezeLo	ed	male
adrianam_4	adriana	female
lilfunkydoe	callie	female
s_gunn	stephen	male
katiedonohue	katie	female
htchelpdesk	ben	male
The_2Jayz	jacob	male
ONeilKennedy	neil	male
mccoy_kaitlin	kaitlin	female
TrotlineDesigns	ron	male
Mack_H_Allen	mack	male
DannyCorral96	jay	male
alexmassa17	alexandra	female
MeshModeler	javier	male
HouseOfE_Calvin	calvin	male
brantschulz	brant	male
madelinecate	madeline	female
kristinhill	kristin	female
kblaze81	kristin	female
ChrisDewald	christopher	male
AlbertoD123	jesus	male
KenOpper	ken	male
Benson_Elliot	elliot	male
JoyJoyblue1994	joy	female
andy28cod	andy	male
LPizzle	lamont	male
Beyerlicious_	haley	female
BernadetteBenSh	bernadette	female
iTzCoLLegeBoii	eddie	male
xdaniiiiiie	danielle	female
amberjmeyer	amber	female
Just_Tiffy_Here	tiffany	female
TheJordanRoss	jordan	male
megan_carroll13	megan	female
kevinlu220	kevin	male
dirtyhorans	jeannie	female
jamfan40	jeff	male
AdamDoty01	adam	male
vierizestrippa	johnny	male
magallaneskathy	kathy	female
Katheriinneee	kitty	female
noealba_	noe	male
mergesort	joe	male
L_Deeds	shane	male
mooney365	diana	female
jessiemaepinky	jessica	female
mgrant76308	mark	male
jwilliamscincy	jason	male
The1BigWalt	matthew	male
nicole_morrobel	nicole	female
Cali_StyleJas	monica	female
SirPoet	chris	male
ShawtySamantha_	samantha	female
leahshirley1123	leah	female
yaboizd	eric	male
nick420welsh	nick	male
_adam97	adam	male
rebekahjayyy	rebekah	female
ClaytonKemp58	clay	male
jesnider	jim	male
LeighhCapss	leigh	female
Georgiaa_S	georgia	female
superdenise6	denise	female
_kayy5319	karen	female
_AbbyT	abby	female
SLOtography	blake	male
JennCKRoberts	jennifer	female
DrDeniseM	denise	female
CTDSportsLLC	john	male
colonelcarneage	keith	male
kellyhmahoney	kelly	female
JKauf105	jordan	male
DanielBeerthuis	daniel	male
jerb796	homer	male
miss_mymarine	amanda	female
fvmbo	sam	male
AdmiralRandall	john	male
KzooPlayer	kevin	male
b_hecky	bryan	male
apalachicola05	wesley	male
nguerreroH9	nestor	male
unideloyale	meghan	female
PPHEricRussell	eric	male
kbarrington11	katie	female
bnataliee	brenda	female
sexci_santi	april	female
kviksilver	boris	male
DeVonJJohnson	devon	male
caake	chris	male
georgehsu3	george	male
Jacki3Roberts	jackie	female
KiiNGxDooMs	dee	female
CarrieLayne3	carrie	female
Forever_with_KP	katy	female
LexCaffi	alex	male
BarryMPhoto	barry	male
Microtrilogy	tyler	male
SylviaCuff	sylvia	female
mllecentre	courtney	female
TheRealElbert90	elbert	male
NoahAnderson09	noah	male
JennyFu3	jenny	female
meekuhla	kayla	female
itsjaackiie	jackie	female
eblaz37	eric	male
LenaBeannn	lena	female
Mariananagju	mariana	female
KelseyLacks	kelsey	female
aleeexlovee	alex	male
qcait	caitlin	female
shneeenss	nina	female
loveroflogos	andrew	male
Renoversity	duane	male
MattieLegend	matt	male
_JoSu356	josue	male
waterwish1972	tina	female
DiversityEric	eric	male
isabelnicoleee	isabel	female
celinagarebear	garrett	male
RubyMcrae	mary	female
josephreed	joseph	male
Yeah_Yeah801	gabriel	male
EmilyNorwood123	emily	female
_oliviamhill	olivia	female
carlyfoye1	carly	female
garyb121944	gary	male
StewartTurton	stewart	male
Guidry4Heismen	matt	male
DannyLRose	danny	male
A_newkirk1	austin	male
joshua_smawley	joshua	male
FreemarketJay	jay	male
straitstunna	jacob	male
hannicavey	hannah	female
mandaaa_pleasee	amanda	female
LDSBoi	chase	male
_trent_ocean_	trenton	male
chaseevanchase	evan	male
DJKahnsworth	cory	male
peeeepppeee	ashley	female
Sheckkd	kirk	male
Stervvvv	steve	male
alii_huberr	ali	male
M_Ant20	melvin	male
LNDANIELSS	ellen	female
LeonYoManTran	leon	male
bwahby	brian	male
SabrinaSelva1	sabrina	female
nicolelauram	nicole	female
DrewGoupille	drew	male
Sydneyyelisee	sydney	male
cedricterrell	cedric	male
ashley_berry3	ashley	female
laurapawlowski	laura	female
sammay_b	sam	male
wilkravitz	billy	male
Mary5433	mary	female
atirehcs	selena	female
HollimanBob	bob	male
ChrisRossTurner	chris	male
ceo_15	colleen	female
Rachel_Lane23	rachel	female
t_fiordimondo	tricia	female
eddie_live94	eddie	male
Nikki_needsyou	nikki	female
ImDirtyT	trevor	male
AJohnsonnnnnnn	amber	female
JoshX1993	joshua	male
JorgeHChz	jorge	male
rocketjohnnyk	john	male
LoveRemarkableU	natasha	female
yoyohomiejoe	jacob	male
RachelJost	rachel	female
WalkerW12	walker	male
Jeffbullard1	jeff	male
jwilson59	josh	male
Mark_Stanke	mark	male
CWGBuckeyes35	michael	male
JayRiggs85	jay	male
D_Blanchflower	danny	male
DonnaThorland	donna	female
taraeubanks_	tara	female
PaigeShipman	paige	female
PeterLaBarbera	peter	male
silvia_cr7tho	silvia	female
CRulofson	chase	male
danielt89291458	daniel	male
icon1166	mark	male
fnichole2000	faith	female
Valhalla_Images	dan	male
annette862	annette	female
NotFromOff	kenny	male
melaniiefr	melanie	female
A_AlcalaJr	adam	male
Her__BUT	kevin	male
CRAndersonWins	christopher	male
lynnyoga	lynn	female
Samanth64196181	samantha	female
MBushMtDemo	mike	male
CameronR_4	cameron	male
Geno_TV_Yaz	eugene	male
ashley__knight	ashley	female
Dj_ODiGGy	octavio	male
alison_vela	al	male
HittleJeff	jeff	male
Ewayney	elaine	female
Saratawfik	sara	female
iBallYouUp13	travis	male
EmilyHart12	emily	female
ElaineG16	elaine	female
JAGTIRE	jeff	male
christinelove	christine	female
TrashItTrevor	trevor	male
RaymondAEdel	raymond	male
She_Ra81	heather	female
andrewbryan101	andrew	male
diane_nedob	diane	female
rajko1973	frank	male
BadgerASF	ashley	female
TeaBrat	amy	female
SRSDT_AHA	sandra	female
danieljakes	danny	male
danicrump13	danielle	female
graciesaygracie	gracie	female
elisakaban	elisa	female
aprillewis69	april	female
MosherMatt	matt	male
Tony_Bonilla_	tony	male
JimenezKTVU	jacob	male
PiraniGabriela	gabriela	female
Lanique_Meow	virginia	female
waltjack	walter	male
vajonjon	john	male
princessjshot	josephine	female
Jesikaa17	jessica	female
AntonM	anton	male
MichaelCovelli	michael	male
Amb_Echevarria	amber	female
ChoicesGregory	gregory	male
charliejaneee	charlotte	female
Micah_Gabler	micah	male
Langley486	john	male
nikki412	nikki	female
yojisub	brittany	female
treeFuker	jane	female
simply_r0yal	nick	male
Smarxhausen	steve	male
newsworthyindc	jason	male
AlexFlitton	alex	male
TheNoahRottiers	noah	male
gingersnapsyou	ginger	female
AndreaSerranoZ	andrea	female
SwampBebJones	lindsay	female
_DJVODA	ryan	male
TPlanner	traci	female
lovealwaysjulie	julie	female
howard	howard	male
GARCIGARS	george	male
Pinchee_Juudy13	april	female
mamiyita01	lucy	female
truelips78	shawna	female
youre_so_FRAY	melanie	female
boyddog	boyd	male
N_Matt1	nick	male
kkkayy__	kayla	female
CarrieQTENT	carrie	female
Eu_nni	ella	female
vmelendez_	victoria	female
AlanBohancock	alan	male
mringard	matthew	male
pizlierson	liz	female
lostonaol	wayne	male
grubreport	stephanie	female
NicoleObregonn	nicole	female
jenniferlevy	jennifer	female
WhereverWriter	amy	female
SchindlerSteven	steven	male
ItsPopoca	angie	female
Jackd22Jack	jack	male
dbmojo1	daphne	female
AaronNoe23	noe	male
DomJax81	young	male
joelpm_	joel	male
CassTVChat72410	cassie	female
EileenMariee	eileen	female
Liz_young55	liz	female
sNickss_	steve	male
Denisebroussar4	denise	female
NatalieDeniseJ5	natalie	female
_ryanrobertson	ryan	male
lilyjordannn	lily	female
kmallett1958	kent	male
Maribabyy_	marissa	female
Jessiejayt	jessica	female
hagonzalez94	hugo	male
KerryHawk02	kerry	male
EBrownDowntown	emily	female
vanessaa_m6	vanessa	female
kred_holt	kimberly	female
brianmhite	brian	male
VanessaMathiew	vanessa	female
sarahtherower99	sarah	female
Brissney	brittany	female
karagrace8	kara	female
_StayBallin_	may	female
RJayBlair	rachel	female
bparker001	blake	male
Kristoefor	christopher	male
joexhunt	joe	male
QuietTimeAquino	marc	male
MitchGrunder	mitch	male
JamesBogu	james	male
kennysullivan	kenny	male
nessabennette	vanessa	female
MyAngelAdvisors	angel	male
billrini	bill	male
SweetPwusySatda	vince	male
kf	katherine	female
aliofthevalley	ali	male
ahamilton001	andrea	female
michellejtirado	michelle	female
ashleyy_m_g	ashley	female
AmandaJSorensen	amanda	female
mkyllingstad	maria	female
Ali_Crawf0rd	ali	male
Jenny_leighann	jenny	female
morgan_sherm	morgan	male
MindyJoyce	mindy	female
mikethemovieguy	mike	male
frankincredible	frank	male
ron_kjcarter	ronald	male
lil_boyblu	leo	male
_BigPoppa65	bruce	male
MiguelCoka	miguel	male
msavityyyy24	matt	male
Fistin_Tristan	mac	male
Emilygr14	emily	female
jnrieman	jake	male
patgoedde	pat	female
kellywachs	kelly	female
Jam_HollBU	james	male
mason_bowman	mason	male
Jburf_96	jacob	male
JudyReppart	judy	female
HorneLynn	lynn	female
Michael_Forbes8	michael	male
neigner07	nicole	female
Ms69Dee	ruthie	female
ReporterJim	jim	male
ayooitslily	lily	female
liviingl0uder	audrey	female
ckhealthworks	cynthia	female
davidgNER	david	male
leah19xx	leah	female
Cory_Cortez	cory	male
JGrayMatheny	jeremy	male
MelEHart	mel	male
K_burbano	kathy	female
Aileen32323	aileen	female
JeffLuce121	jeff	male
Tanyarios	tania	female
FutureNews2Day	michael	male
TROYDRAYTON84	troy	male
thegoldenmuzzy	nick	male
JBAwardsCircuit	joseph	male
Alyssaa_smithh	alyssa	female
ORIGINALTRAMP	isabelle	female
bakerhhhs	chris	male
aliciawzhere	alicia	female
Tiny_chivette	brittney	female
NateMichalek	nathaniel	male
RiggsJordan12	jordan	male
channel0range	karla	female
hakimxo	taylor	male
samcrowlz	sammy	male
kencole77	efrain	male
emilydollar18	emily	female
Mr_basketball02	odell	male
bella_corbitt	isabella	female
annie__lev	annie	female
SexzyMexzy	gabriela	female
__GTLoves	malcolm	male
paulette01234	paulette	female
jessicaaa020	jessica	female
Shellbell2015	shelby	female
Chris__Glenn	christopher	male
imma_JEM	jessica	female
honestal1944	alice	female
amanda_w_v	amanda	female
stephyRN97	stephanie	female
ohitskevinc	kevin	male
JimmySuzuki	jimmy	male
kxrenmedina	karen	female
BryanAlexOrtega	bryan	male
Blahkel	blake	male
_Derriyanaaa	queen	female
NyleKorz_16	kyle	male
KatWilliamson12	kitty	female
BURN_itsKelso	kelsey	female
sportsguybrock	brock	male
AH_Linkin	chris	male
OGee_Sam	samantha	female
JHoops_0	josh	male
TapaNava	carlos	male
MsKelySprinkles	kelly	female
adam_c_wheeler	adam	male
jordannnnns	jordan	male
nicolelemmo	nicole	female
jhnkltnr	john	male
divitomia	mia	female
danielledonova1	danielle	female
dribaby123	adriana	female
JaredLSloan	jared	male
jennalcaravello	jenna	female
yourboyskam	erika	female
tthasit	jacqueline	female
Duhlirious	ryan	male
nickwhitmore1	nick	male
rissalba	marissa	female
cdesignscards	christa	female
TheRealJTT_	jordan	male
Sergiogtagle	sergio	male
jordankacy34	jordan	male
LesPommettesLa	les	male
bfitz914	bryce	male
juhjenna	jennifer	female
ashattckz	ashley	female
jdavismemphis	joseph	male
steven23isback	stevie	male
owenjerome	owen	male
davidjeet	david	male
R3ckl3ssHarmony	ashley	female
tomobrien_1	tom	male
itssjeannettee	jenny	female
LeannaFornabaio	leanna	female
grrlaura	laura	female
jwbast	john	male
MikePettymusic	mike	male
WBTVSteveO	steve	male
fls102204	frank	male
mescudrey	audrey	female
sacmcdonald	shannon	female
paganeo	fernando	male
Itsonly_amanda	amanda	female
_lilyewest	lily	female
kirklander61	charlie	male
skeptomai	christopher	male
b_alvy	brett	male
RJDuenas69	ricky	male
mulaa_a	queen	female
jpasalagua	juan	male
richhomiehay	haley	female
HilaryCotton	hilary	female
carlosecubias	carlos	male
orfanela_2	brittany	female
TORsAdventures	victoria	female
Greg_OhDamn	greg	male
meggann_1	megan	female
vcestodio	victoria	female
gutierrez_ivy	ivy	female
hannahhhbaby	hannah	female
SofiaGuzmanMz	sofia	female
alan5959	alan	male
QualiaNetworks	michael	male
_RackSydyBitch	sydney	male
Xcalante	andres	male
jamescardenas45	james	male
jesssicapadron	jessica	female
sebobessed	melanie	female
travisWfreeman	travis	male
JaeBoz	jake	male
horseflynawall	kari	female
PaulHeroux	paul	male
hmsparks123	hunter	male
BConroy16	ben	male
jonathan_444	jonathan	male
lil_haywood	young	male
dillonthevillan	dillon	male
terrygazza	terry	male
kalinowski_liz	elizabeth	female
_katyhill	katy	female
IversKevin	kevin	male
rugbyyank	nathan	male
SK_15cent	rocky	male
steveaoki	steve	male
Tstauffer21	taylor	male
maureen_hart	maureen	female
mikebrennan364	mike	male
whtvrTeresax	teresa	female
Arturocota95	arturo	male
jmossey53	jennifer	female
mikyjaz	tina	female
mammabasso	mia	female
LeonF63	leon	male
broookelynnnnn	brooke	female
cashewhugs	derrick	male
EDEEEEEE	edwin	male
NatalieAVasquez	natalie	female
_KingTutttt	marshall	male
colleenubl	colleen	female
meganqweenster	megan	female
WPrestwich	william	male
sar_dont_care	sarah	female
101PCHCruzGirl	lisa	female
Julezillaa	regina	female
aileenmcole	aileen	female
sarahmatch8	sarah	female
vincentjames80	vincent	male
Joeyfunkhouser	joe	male
Debbie_Isaacs	debbie	female
syntax72	darren	male
gabel_robert	rob	male
miradyan	miranda	female
Jmoneylester	jonathan	male
MARendless	marlon	male
Srl123Ok	sheila	female
laurajuliana205	laura	female
JuLiusOrosco	julius	male
_BennettToWinIt	samantha	female
AdamChester15	adam	male
kayla_rahe	kayla	female
christiestelly	christie	female
joncoopermusic	jon	male
_juicyA_	amber	female
sophiaamuratori	sophia	female
therealalexis00	alexis	female
mednurse202	vickie	female
MindyPopp	mindy	female
jonah_stalsberg	jonah	male
amyalisha96	amy	female
martha610130	martha	female
sAndReEzZy	sandra	female
LindseyKloss	lindsey	female
LightLover436	jenny	female
yungstates	cynthia	female
thebigmikemiles	mike	male
THEREALthird	benjamin	male
joemandersonTV	joe	male
JoeSheezy	joe	male
CaitlinKaser	caitlin	female
annasadler3	anna	female
samrose2195	samantha	female
JamesFCarrigan	james	male
lifeasboss424	beau	male
drewage_	andrew	male
NotUrAvgLipstck	christine	female
ncoronges	nick	male
burryfangirl	sarah	female
Mikey_Feldstein	michael	male
ash_mor923	ashley	female
WittlePaige	paige	female
MikeKikeson	mike	male
NoahGrider	noah	male
katielynnwise14	katie	female
bath_saltz	joe	male
JCSmalls3115	casey	male
RyanAmirault	ryan	male
KarinaaaAmanda	amanda	female
ludditeblogger	ruth	female
alyssafry_	alyssa	female
eriq49	eric	male
dontfwme2003	sandy	female
justinthreee	justin	male
AshleyRhonC	ashley	female
John_B_Cole	john	male
MrRory	rory	male
MissJbin1	julie	female
sweetsoleil	ashley	female
RyannBreezyy	ryan	male
GabbhyGracia	gabriela	female
joealzate	joe	male
GurlReed	brittany	female
kristenrogers71	kristen	female
katie_yost	katie	female
bpalafox23	brandon	male
antonio_q24	antonio	male
zukovka	nathan	male
FRESH23_	marlon	male
omahajon	jon	male
jackmorgan	jack	male
SicaSociety	jessica	female
gwen_rivera	gwen	female
YoGabbaMo	bertha	female
_2kShawn	shawn	male
joshradio13	joshua	male
Breakthecycle2	damian	male
148100sharon	sharon	female
Flyer_thanu2	kenny	male
sgs080208	gail	female
RafaelShephard	rafael	male
JessieCasciano	jess	male
CARNEivalcruise	rachel	female
vinlich67	vince	male
coffeesister	dorian	male
AndrewRen__	andrew	male
BrittaRohrssen	brittany	female
GlasperAg	alison	female
Nigzyy	sheldon	male
amberphillippe	amber	female
PuryearBoi24	adam	male
ryanguard	ryan	male
tontin_1115	carlos	male
sopheyscope	sophie	female
jimkennedy250	jim	male
NickeySharon	sharon	female
TeamStarGary4	gary	male
Wisky_Girl	kristin	female
Brittanyyyyu	brittany	female
music4eve_1D	wendy	female
joeresto54	emilio	male
KelseyyReesse	kelsey	female
ASephiroth	andrew	male
catfishrissa	marissa	female
stephashleyy	stephanie	female
diamondisc	doug	male
BiebersTimbits	justin	male
KbKriso20	kris	male
marques_jules	queen	female
keith2282	keith	male
erinnkellly18	erin	female
AWill_35	april	female
joshfranz	joshua	male
pearldini	kayla	female
MarcMero	marc	male
cee_lowwww	chelsea	female
TPrice504	todd	male
ElizabethOnFood	elizabeth	female
Gaga216	shawn	male
ferrisnicole1	nicole	female
katieingalls	katie	female
Damizzle090	damien	male
IAmOfficialMel	mel	male
ChrisMWebb	chris	male
PaintedMidget	julian	male
seasheIbs	shelby	female
PickleSoSolid	lawrence	male
Ps1953Spurgeon	pete	male
trakstarr4	anthony	male
lizkcollins	elizabeth	female
BryanPerson	bryan	male
clarisssa_t	clarissa	female
Paul__Connolly	paul	male
itsjakenielsen	jake	male
freedomrider23	dee	female
FrauCyberninja	krista	female
fbarryii	fred	male
MrFearrin	tyler	male
jordanvazquez14	jordan	male
FreeeeSpirrrit	christine	female
Jenna__Kaufmann	jenna	female
MisheMishe322	michele	female
raquel_l_taylor	raquel	female
santosvillegas	santos	male
irisandlouis	iris	female
RiemerAlexis	alexis	female
kimbesen	kim	female
iamAlexMendoza	alexander	male
rach_sem	rachel	female
Drewguyver	drew	male
jessro_13	jessie	female
JerardB54	alexander	male
annaluxion	anna	female
KeithJawahir	keith	male
Jonathaandlp	jonathan	male
Simplekindoffan	dean	male
get_er_done_now	shawn	male
HerdAlumni	marshall	male
lance_crowder	lance	male
MattyIce_51	matthew	male
samanthalw4	samantha	female
sammiracle7	sammy	male
ArthurA_P	arthur	male
MatthewKkeleman	matthew	male
jmss	jennifer	female
Gator_Bait7	will	male
blakeells	blake	male
CoachSRyan	sean	male
RConnema	richard	male
RickBelow	rick	male
karlabaezxo	karla	female
teribond	teri	female
PhilMcniff_3	phil	male
CalebLaShan	caleb	male
kgilmore11	kyle	male
BrokenZoetrope	seth	male
Simmy3Tara	tara	female
maggieeweaverr	maggie	female
Doritotacos	brooke	female
davidkassar	david	male
akidnameluis	luis	male
mattlanger	matt	male
_AndrewLong	andrew	male
DashingHector	hector	male
auntdududana	dana	female
Mpalmer3Matt	matt	male
LaBelleKevin	kevin	male
emilyhutson413	emily	female
ReneeJurewicz	renee	female
ItboyJones	nick	male
TexasChance	chance	male
OfficialOmarN	omar	male
jstrange025	james	male
HeidiRuns	heidi	female
fanymartinez_	stephanie	female
SRobertsKRON4	stanley	male
alexmkzero	alex	male
ShowBizz36	elijah	male
JohnTho87155750	john	male
autumnnmcc	autumn	female
sandrastrahler	sandy	female
Lilkennyp_23	kendrick	male
BRoman30	roman	male
sid_22	steve	male
LizNgonzi	liz	female
SSGRACESS	grace	female
mnone	lynn	female
Nick_Dvorak	nick	male
aggcxx_	ana	female
rockchalk4583	liz	female
marissaroe	marissa	female
BigBoobmpls	reuben	male
itseriiin	erin	female
yblamar	ken	male
jessicawunder	jessica	female
patribble	patrick	male
nolte14	adam	male
vindecatedmeow	amy	female
JohnJohn_Little	john	male
Aaron_Lee2	aaron	male
guthrie_rob	robert	male
FzProbst	chris	male
iAmGodhbu	charles	male
tylerdiaz402	tyler	male
Enoremous23	erick	male
VernonQuaal	vernon	male
ariel_marksbury	ariel	male
308af7ce58094f3	jesse	male
GothamEthicsDoc	patrick	male
imajrgolfmom	andrea	female
LByronK5	linda	female
hopeelessss	hope	female
BrandonAcevedo_	brandon	male
LuluL1985	laura	female
YouGotMails69	courtney	female
DRdiabloTHW	dan	male
heykeke_	keri	female
EvaZspot	eva	female
sotomario90	mario	male
juanruiz1799	juan	male
nelhewitt	danielle	female
jrobledo14	joshua	male
1gretchen	joyce	female
PazTres	pablo	male
GingerFreak_	nathan	male
iamechelon1978	sarah	female
flint_4389	christopher	male
Greg4KS	greg	male
dxbarra	daniel	male
BobPolglaze	bob	male
olechiet	alvaro	male
JohnnytooG	johnny	male
ScottCottos	scott	male
chriisverdugo	christopher	male
megan_bellomy	megan	female
DavidNunoABC13	david	male
MadgePenfrasha3	madge	female
DominicWolfe	dominic	male
sbiel2	steven	male
crisismattie	mattie	female
ParryRacer	doug	male
sndrsng	sandra	female
katrinakalamar	katrina	female
Mittenslol	christine	female
AndyMcLane	andy	male
TGStoneButch	corey	male
sydneyrosss	sydney	male
AaronBro16	april	female
karlytaa12	karla	female
RandyLewis88	randy	male
cindyluvsTPAIN	cindy	female
Dav_v_oochi71	david	male
LongLiveAndrea	andrea	female
sebaschultzr	sebastian	male
EmLouise01	emma	female
clam_jammer	michael	male
melissajaneung	melissa	female
docemari_	maria	female
juliioalexis	julio	male
playwithurcucc	frank	male
rubenskib	ruben	male
Erika_2717	erika	female
flyyboyjere	young	male
Angie5050Angie	angie	female
MarcKellyMN	marc	male
jennifercassada	jennifer	female
BrodyismeFriend	steven	male
jade33870	jennifer	female
W4JTP	jim	male
DiZzyLuvsU	alejandra	female
ColeMcDowell2	cole	male
JenHickeyy	jenna	female
kelsey_rieger	kelsey	female
toricarnahan	robert	male
_xohannnah	hannah	female
WWsugden	william	male
jeffvenuti	jeff	male
JaredBBC	jared	male
theloganbeaver	logan	male
Jefreywsx	jeffrey	male
DianaE38	queen	female
gsp143	ross	male
spicer2308	scott	male
BudLightPlattys	ted	male
1pbeale1	pamela	female
brittanyypatton	brittany	female
kirstendj1	kirsten	female
alynchhh_	alex	male
ClaireDisler	claire	female
scifidiva24	donna	female
SJTAPres	jennifer	female
wheres_walle	nancy	female
HartleyKatelyn	kate	female
JenniferMackie8	jennifer	female
ABBsolutelYnott	abby	female
ebukstel	edward	male
C_free111	cody	male
kateressx	kate	female
AlexisEvansx	alexis	female
laurenpizzolato	lauren	female
afunkychild	monica	female
thereal_dhall	derek	male
kennybear15	kendra	female
TheSweetestLew	lewis	male
CliffPaul_3	april	female
DioramaWorkshop	frank	male
Whos_Luis_	luis	male
stxrmcloak	alissa	female
momo360	mohamed	male
DylannMartinn	dylan	male
J_Silvestro	john	male
tanisharenee_	tanisha	female
IngthirInhacre	dennis	male
jessieeblumberg	jessica	female
drjmunsell	jason	male
wildasadaydream	stan	male
GracieSchafer	gracie	female
DrippinSauce22	robert	male
bvelaski	brandon	male
AdeleGLux	adele	female
noahmp	noah	male
DanielWZDC	daniel	male
Henner_	hannah	female
bbaker1818	ben	male
SDanikKIMT	sarah	female
WCKidRock	rob	male
JiGGAsan	tyrone	male
Macshoe6	ron	male
RHumms25	ryan	male
melicakes8	melinda	female
sandraym	sandra	female
MJTek_15	chester	male
TheLBPSpeed	wilson	male
Jennadonato_	jenna	female
francis_b96	francis	male
chiossone	carlos	male
sexylexitoyou	alexis	female
markmchog83	mark	male
The1RealZay	isaiah	male
nikkiwattles	nikki	female
jwclark	jim	male
sjsharks9	eric	male
bcaas16	briana	female
PatDorneyofCHS	pat	female
RC___Cola	ruben	male
alyssafeltz	alyssa	female
carlygarrison87	carly	female
xolinaro	lina	female
SBunnWard8	sheila	female
RALight4	ricky	male
savannaadrew	savannah	female
Cconcepcion_123	concepcion	female
Brydz88	ryan	male
britttfriedman	brittany	female
blairyyyy	blair	male
alang_15	anna	female
SharkkDick	cody	male
Houston_CP	houston	male
DenverCP	denver	male
Crystalio26	crystal	female
_JimmyReed9	jimmy	male
Cowan4President	hannah	female
FDRAKEJR1	frank	male
ewags123	elizabeth	female
brandonalfred_	brandon	male
andreap13	andrea	female
KONeal_10	ethan	male
SDHotelMan	david	male
OShea_S_T	shane	male
isaacrobert_	isaac	male
CharlotteCP	charlotte	female
HOOKem0	philip	male
Chance_Fischer	chance	male
Stephanierowber	stephanie	female
rlgems	ronda	female
samlizabeth	samantha	female
ColemlewDj	lewis	male
r_hendricks	rachel	female
oliveira_pedro0	pedro	male
McCoyDotCom	kendall	male
Hey_JessHey	jess	male
svershbow	sophie	female
Lannabug95	alana	female
TiffanyStubbs4	tiffany	female
Danielle21A	danielle	female
capn_danger	jon	male
eheacox7	ethan	male
angieserkiz	april	female
aaronhwk	aaron	male
TheOtherMcManus	bob	male
MrFRojas	fernando	male
taramoore1999	tara	female
sabwilson	sabrina	female
TySmith19	ty	male
Vickilalune	vicki	female
socoloko	adam	male
hineybush	josh	male
nictartaglia	nicholas	male
FrankieAmore	frankie	male
Hamlet	chris	male
PeaceLoveTrees	ashley	female
kac22004	kim	female
CharlieGaarcia	charlie	male
LukeCampbell03	luke	male
the59thStBridge	anne	female
UMichJessica	jessica	female
agmagana	alma	female
_LuisAguillon	luis	male
veronniecaaa	veronica	female
tR7p	ashley	female
alexisaddams26	alexis	female
JamesKratchHS	james	male
schnabesss	kristen	female
iriscanoo	iris	female
melverschoore	melanie	female
Amy614	amy	female
haethos	alex	male
SpencerLew	spencer	male
dallasmom53	linda	female
dazedcorpse	emily	female
Jkp815	jordan	male
CaraBorini	cara	female
aaronebare	aaron	male
JFMcMullen	john	male
djroc213	dylan	male
samanthaabroo	samantha	female
SabrinaSmith893	sabrina	female
ellenigma	ellen	female
Bernserker	james	male
MichaelIanPPete	michael	male
AlexisOwen_	alexis	female
justfrankmyers	frank	male
onlineauttie	autumn	female
APkristenwyatt	kristen	female
AshleyMova	ashley	female
ksuter	kevin	male
Yongsiez	yong	male
chadeaynealyssa	alyssa	female
laraalcantara1	lara	female
adtrnick	nick	male
KReidiculous	kristin	female
TheCarlTU	andy	male
aafjudy	judy	female
melissacv	mel	male
MC_freshSwag96	mason	male
takeheart4	vanessa	female
jmaloney_	jenna	female
StacyRoss_chek	stacy	female
alex_cheko	alex	male
N0AH11	noah	male
ohheymique	anthony	male
JennBrown237	jennifer	female
nicoleannnee	nicole	female
mennitixo	michelle	female
marinacastro1	marina	female
RonRubinkowski	ron	male
issy765	israel	male
gmcquadee	george	male
A_Mak11	allison	female
PaddyJ1325	patrick	male
LC9FOOTBALL	luis	male
julieleyva398	julie	female
brandon_gt	brandon	male
juullls	juliana	female
JayAaaTee	jacob	male
AkkProd	austin	male
nikkayygeee	nikki	female
TheDomino	dominic	male
JKells23	jordan	male
Tillweezy	nick	male
jsav132	joe	male
karin_bean	karina	female
McPhailDiane	diane	female
KayleighWolf1	kay	female
angelo_faiella	angelo	male
TroyMaxcy	troy	male
alexweisler	alex	male
kunze_patricia	patricia	female
T_Bird36	taylor	male
morgan_dalziel	morgan	male
SabrinaMichele	sabrina	female
TheGoatNation	christopher	male
AnaGortari94	ana	female
spencerholbrook	spencer	male
katelyn_emily	katelyn	female
CrystalCj60	crystal	female
GwenClapperBPI	gwen	female
m_chustckie	maggie	female
andyfeelsu	andy	male
Skyzook	summer	female
DebraJosephine	debra	female
checogutierrez	sergio	male
davidwhitice80	david	male
Astreeter2654	johnny	male
BelieveToUnite	alexandra	female
Bernadyn99	kyle	male
JesseHorvath_98	jesse	male
RealGrantMorrow	grant	male
christopherburd	christopher	male
Octavio_MF	octavio	male
nick_castro22	nick	male
MrsCarey_HHS	lisa	female
liannakei	shane	male
itsyimikaaaa	april	female
PreX_Dreams	jordan	male
DanPhilibin	dan	male
Jeffrey_Jue	jeffrey	male
lr3031	lou	female
aj_mommy03	veronica	female
lane_waymen13	lane	male
brandonbud401	brandon	male
Chreeestal_	chrystal	female
rocketman528	jeff	male
BillieBoyMitch	tony	male
jones2319	diana	female
NatDelfs	natalie	female
mtessler	mary	female
chase_hines	chase	male
Cherkasova1737	anastasia	female
Elijahreynold11	elijah	male
esthercasting	esther	female
mitch3680	mitch	male
ErinNationn	erin	female
CaraballoLemuel	lemuel	male
MsJFaye	jasmine	female
ji711	jon	male
nerd_alert	angela	female
RobertYates1982	robert	male
railroader13	shaun	male
hey_vanni	beau	male
anavibm	ana	female
CGuluzian	christina	female
HARVEYT10	tyler	male
mohammad0994	mohammad	male
NowJoshua	joshua	male
dsal_29	david	male
DevBot35	devin	male
xJoMama	jordan	male
bensloan83	benjamin	male
MulcahySeth	seth	male
Yenni_fur_	jennifer	female
LindaCharbonne3	linda	female
baronboulle	jon	male
sophie_waz15	sophia	female
Jessesgirl2014	jennifer	female
PatBurns20	pat	female
allisunrae	allison	female
obedearxxi	andres	male
mreilly22	melissa	female
EarlSkakel	earl	male
KatyKelnhofer	katy	female
sportsmom18	donna	female
rachel_austin21	rachel	female
dylan__ck	dylan	male
Shapperdacapper	scott	male
CoryReeder	cory	male
Sugalean	frederick	male
susyva29	susana	female
walldesigner1	nina	female
nicoleschmooze	nicole	female
nattyyggg	natalie	female
IckesKatelyn	katelyn	female
dvuj	david	male
TannerBachelor	tanner	male
SaraECain	sara	female
brandoacovski	brandon	male
RClewer	ron	male
MeanMarcAsh	marc	male
SuperFantastic6	alex	male
elgatomojado4	alonzo	male
tsibilla	tom	male
Ahauptman	amber	female
Rosiediscovers	alison	female
julianareminder	juliana	female
Mr_redtabb	jed	male
marlondane	marlon	male
EmilySpearman7	emily	female
DeniseRan	denise	female
patdilon	patricia	female
MEWlulu	megan	female
hmarie086	hannah	female
hannahniles2	hannah	female
rafalkoandrew	andrew	male
AlexVenglarcik	alex	male
belatucadros	brian	male
taylor_jordan14	taylor	male
nething4selena	selena	female
katerae8	kate	female
CammyWest	cameron	male
miaarosee1	mia	female
photo_archuleta	archie	male
Savagee_19	jessica	female
beyer24	eric	male
weather_outside	miles	male
Katie_Kidd_10	katie	female
AudaciousBeat	mason	male
mporche13	megan	female
doogs_3	michael	male
myangeljill	peggy	female
Pvsssy	johnny	male
TheRealDC_804	danny	male
kasaayyy	kasey	female
darrellgerard	patrick	male
JohnFromCranber	john	male
omvali	omar	male
t_clarkiee	taylor	male
Libbyjean2	queen	female
sammgiese	sam	male
hheck12	hans	male
Blissfulleslie	leslie	female
djacobs	david	male
LauraLynnEmma	laura	female
pepperosepizza	rose	female
malloryedaniel	mallory	female
OhhhKelseyy	patty	female
krystalrosamin1	krystal	female
iamsilva2	chris	male
Melissa_RR	mel	male
ECIndianawx	byron	male
joell51868	christy	female
xcnguyen	christine	female
TravSwag	travis	male
GetStupid5	jason	male
amircollier	may	female
Itsa_PizzaParty	michael	male
Saamm_Bamm	samuel	male
chicagoaflcio	chi	male
lindseyroesti	lindsey	female
instilledchaos	rachel	female
laauur_	lauren	female
_kaylaferguson	kayla	female
AlexEscamilla97	alex	male
doratrillo	dora	female
dsmitchell98	daniel	male
David____Torres	david	male
brchthe3rd	robert	male
frankdieSEL	frank	male
MichaelSchettig	michael	male
NunanCBA	sean	male
JakeMullis14	jake	male
hannahhellenn	hannah	female
tdunyon	taylor	male
fjb1073	becky	female
Capt079	steven	male
TylerAltrup	tyler	male
ohiomail	emil	male
Kyle_Ryan95	kyle	male
censnoring	mel	male
Minionlover60	rhonda	female
sburruel	sylvia	female
chisolutions	chi	male
LielaDAVIS_	deana	female
SamHTFC	sam	male
B_Grade	bryan	male
Overholtz21	gavin	male
Ouisweetie	samantha	female
dommmyg	dominique	female
AAntrum	alfred	male
lesaann98	lesa	female
VaughnSantiago	vaughn	male
Kyle_MacLachlan	kyle	male
erinashleycox11	erin	female
JacobF_33	johnny	male
JoeMulatto	janelle	female
chronodiem2	jonathan	male
SGeloneck	shelly	female
VelvetK70	kevin	male
LouiseKinross	louise	female
julianaferrara_	juliana	female
noahhoffeld	noah	male
MovingToVegas	julie	female
jakeriedel14	jake	male
billlabrie	bill	male
MarkSchutz_	mark	male
kelly42fox	kelly	female
EllisVG	ellis	male
mercijamielee	jamie	female
LiquidLeeroy	jake	male
qualityrye	ryan	male
plmartin68	perry	male
henrymack	henry	male
rachelrosendo	rachel	female
ryanmatthewcruz	ryan	male
peetalarsen	peter	male
jordanmossa	jordan	male
Jon_Vaughn	jon	male
miratim	tim	male
mgcuthbert	michael	male
JohnLis1125	john	male
mbroome_jr	milton	male
teddyelwood	theodore	male
alextarhini_	alex	male
nightrise_	eliza	female
taramanis	tara	female
lauriehollmanph	laurie	female
c0urt_ney4	courtney	female
richtigsinnlos	jim	male
carliejm	charlene	female
kenkousen	ken	male
ChristinaSoCool	christina	female
erin_brosnan	erin	female
ChrisSpencerFL	chris	male
shannonyekcih	shannon	female
wyattmichelle	michelle	female
MayorMorrissey	larry	male
saltwatershawti	ariel	male
GPM018	gary	male
_MariaPetrova	maria	female
NOLAChamber	nola	female
natalialfonzo05	natalia	female
VanessaJack	vanessa	female
_Morgan_Smith_	morgan	male
tmschantz	theresa	female
TaylorSp	taylor	male
hmetheresa	theresa	female
hookahking93	mohamed	male
B_Hollins55	bruce	male
JennayRo	jenny	female
AngelaMTan15	angela	female
alyssa_tompkins	alyssa	female
RussVentimiglia	russ	male
Kstrayhorn9	kenny	male
zanesmifff	zane	male
CHARLIECHEAPASS	april	female
nolaagent	michelle	female
EdwardAnastacio	eduardo	male
MoBioMDx	shaun	male
tia_sondej	tia	female
ROBERTYOUNGJR1	robert	male
chrisjockey	christian	male
0222fed25477488	jeff	male
perkis_power	james	male
STeddlie	april	female
babyazul3	esperanza	female
AbigailSwanson7	abigail	female
asidee	ashlee	female
stephinika	stephanie	female
JoyOverbeck1	joy	female
CSandovalAXP	carlos	male
Maz_LB5	april	female
JulieBthatsme	julie	female
SimonCareers	simon	male
ChiefScribe	steve	male
JimGillette	jim	male
calidreamin17	amy	female
DrugFreeTrippyy	marlon	male
pghconcierge1	robert	male
Simply_Niyahh	june	female
coolpunkchik182	mandy	female
VincentHudson4	vincent	male
Brejal	audrey	female
Katelynnxxoxo	katelyn	female
rol2s	carol	female
StephenSilver	stephen	male
TylerJKoch30	tyler	male
paigejacs	paige	female
tannereaves82	tanner	male
amanndamckenna	amanda	female
hey_its_shea18	molly	female
dddaaalllaaasss	dallas	male
LevityNYC	stephen	male
wutjackie	jackie	female
DGriffithsMM	david	male
HaightTray	sonny	male
_thatdopemfx3	jay	male
RyanKrzykowski	ryan	male
kelsssox	kelsey	female
Shawn27McCall	shawn	male
rita215	rita	female
angggel14	angel	male
NANPROUDOSUFAN	nancy	female
Morgan_Detoro_	morgan	male
loveandrew_	andrew	male
kendeldunn	ken	male
LIBTARDSSUCK	thomas	male
velv14	valeria	female
Larissa_Rae_	queen	female
ReggieBradford	reggie	male
meggerrzz94	megan	female
holllla_itslex	alexis	female
BeeeBieber	brittany	female
TrentaBitch	sebastian	male
4starcashier	nathaniel	male
taylor_alanna	taylor	male
ktarheel	kenny	male
WildblumenInk	megan	female
hannahkrams	hannah	female
lpetermeier	lindsay	female
IAmJoshuaRay	joshua	male
SumnerIsland25	ryan	male
nathansfleming	nathan	male
NatSweetSisters	amy	female
_gmo97	bill	male
pipp_squeak	brooke	female
captnkillacvnt	joanna	female
Michiganbelle	paula	female
THEREALPRIME_25	allen	male
Ron_Clements	ron	male
briibossse	brianna	female
rissrodz	marissa	female
JDog5897	joe	male
_whatdaHAL	haley	female
eeric_k	eric	male
supermomma8134	andrea	female
stefsmilo	stefanie	female
jenny1605	jennifer	female
wenanderson	wendy	female
bennettoford	bennett	male
MexGardener	jose	male
chelseabraves	chelsea	female
jmapping	justin	male
E_Johnson5	evan	male
jasonmp85	jason	male
LaydieBuggML	donna	female
Admirebymost___	jay	male
NateThaMorris	nathan	male
bbecksie	becky	female
I_wear_khakis	jake	male
_BKramer	brandy	female
mo11yyy	molly	female
whitekidanny	fanny	female
pcarson81	phil	male
vivafanny	fanny	female
MirandaRod93	miranda	female
KaraKolo_	kara	female
Ace2shay	kevin	male
alexmikerivera	alex	male
MorganSausser	morgan	male
mccormallie	anna	female
follow_jesse	jesse	male
snichs_	sarah	female
geerichardson1	regina	female
bxzingxirwin	louis	male
brookegoesel	brooke	female
jediknightron	ronald	male
RudeBoy_Black	darrin	male
jeje66	jeff	male
WeeItsBri	brianna	female
tomshen	tom	male
Meggsssbby	megan	female
james	james	male
Mattyivarsson	matilda	female
StephanieClark_	stephanie	female
Patrick_Cuh15	patrick	male
Djkeatzz	dennis	male
Noah_J_Hall	noah	male
martinrsummers	martin	male
Drewster1012	drew	male
LindsayHCharles	lindsay	female
Mattlee2669	matt	male
bheisse	bob	male
DSServiansky	daniel	male
XxDawg_PoundxX	clay	male
daviday	david	male
LauraFicher	laura	female
andewtheidiot	andrew	male
katiezez	katie	female
MaggieMaeFish	maggie	female
sammauter	sam	male
TD33	lee	male
cflick10	christian	male
TCI_Turfgrass	jon	male
kyleheeter	kyle	male
RachelMacDavid	rachel	female
TrueTeflonDon	johnny	male
nick_olson5	nick	male
LNestenfelder	ellen	female
JoFaSho2506	joseph	male
rcorey	rick	male
JasonReyes517	jason	male
StephenPierceAU	stephen	male
Maryluamarillas	luisa	female
hiben_sarah	sarah	female
gabriela_coraci	gabriela	female
mary_tran_	mary	female
uwannabeeameyer	katie	female
deadponies	robert	male
CassieHosp	cassie	female
MattPoss	matt	male
hopebrownie	hope	female
BeaRubey	brittany	female
DanielleArena2	danielle	female
RandyHusker	randy	male
megan_geurtz	megan	female
jacobyingling43	jacob	male
mamamereee	meredith	female
danielbautista	daniel	male
_baroudII	jack	male
mingoramirezjr	domingo	male
ROCKYBOIMAN50	rocky	male
AdrianaAgapie	adriana	female
SensualAntennae	sarah	female
RevKathleen	kathleen	female
IceMan_PJA	patrick	male
ChgoDenis	dennis	male
lvjoan	joan	female
LoganGHughes	logan	male
thomasRcarano	thomas	male
2PHrozen	marcus	male
shelbyyheart	shelby	female
wong_alexa	jenny	female
EricClarkXXX	eric	male
xo__belinda	april	female
pudgletwudglet	alex	male
animenoodles23	sammy	male
savialbright	savannah	female
sabrinaryan_xo	sabrina	female
KaylaRo99203561	kayla	female
dafishyyy	donna	female
carolbwin	caroline	female
danielcdugan	dan	male
Shasta81582735	christa	female
annasiebeling	anna	female
ktmeeks	katie	female
NJEstates2	jane	female
ITD_Michael	michael	male
jill_rowley	jill	female
FRANKONEY	frank	male
NYC_AndDoingMe	john	male
j123_jessica	jessica	female
ChrisC0e	chris	male
luv_my_NKOTB	krista	female
ayee_daisylove	daisy	female
m3lizabs	morgan	male
diskrod	tony	male
BonnieLies	bonnie	female
KLopiccolo	kayla	female
Stokes24	beth	female
98WatersS	seth	male
marissalyse	marissa	female
blivieri	barbara	female
TheBakonater	michael	male
mel_roome	melissa	female
C_Lee_Luh	lila	female
UnPerroDeSuerte	lester	male
LindaMauro1	linda	female
MANGOJUUCE	young	male
AbbyJulian77	abby	female
Maliquej11	young	male
SteveBattaglio	stephen	male
valeriajrz02	valeria	female
alexschmidty11	alex	male
MicheleGiammell	michele	female
rogosamm	sam	male
boudreau_paul	paul	male
l_smiley14	lorena	female
CarolynCHolland	carolyn	female
Rodriguez_729	christian	male
matteoyfc	matt	male
Brandon_Winning	brandon	male
slevandee	steve	male
ShelbySpecht	shelby	female
ruthlzbth08	ruth	female
BTRDriver4eva	joy	female
AlonzoHudkinsiv	alonzo	male
francisbaconegg	barbara	female
Wyatt_Miller10	wyatt	male
Sunset4life	cheryl	female
RespectMaarrrio	mario	male
hbadger1221	heather	female
HectorToreto	hector	male
Carlitosguey86	carlos	male
CourtneyHenn	courtney	female
IsaacB23	isaac	male
JasonJoaqinJr	jason	male
babemyles	ken	male
jetsjets1028	joe	male
johnsextro	john	male
alerod78	alejandro	male
MonicaCalaway	monica	female
5footSHORTy	rebecca	female
Asucsy	arthur	male
IGNACIOGALDOS	ignacio	male
ayyyandreww	andrew	male
StoicMLG	andrew	male
deidrelsmith	deidre	female
mgravittaolcom	mike	male
fruitlandis	olivia	female
ryannMcK	ryan	male
Austin_Rae_	austin	male
FallBallTap	joshua	male
Natalie_Ann23	natalie	female
Taylorr21Mackkk	taylor	male
Whtvrsonia	sonia	female
NorthBamaWX	micheal	male
alitha_tejeda	alejandra	female
AppaloosaGuy	carl	male
cody1998tye	cody	male
Bkdoodles1	danielle	female
BlackBauer23	ernest	male
mmttaylor36	melissa	female
evandahm	evan	male
alyssajcstyles	alyssa	female
Noble_Rachael	rachael	female
Jonathantrains	jonathan	male
Alex_Driskill24	alex	male
JonMitchellPI	jon	male
_shemily	emily	female
O_NiAoidh	olivia	female
emmamacktaylor	emma	female
n5pa	alan	male
Nessa942	vanessa	female
NatRaePeek	natalie	female
melissabr0wn	melissa	female
Marissa_White16	marissa	female
ChrisWurster	chris	male
allycat_j	allie	female
KenHerron	ken	male
Indigo467	christian	male
EJFrye	erin	female
ALWAYSCLOSINGIT	marc	male
daisyxavalos	daisy	female
SLDdc	stephanie	female
nanchiiz	nancy	female
ksooyschultz	katie	female
monicabyrne13	monica	female
Kenz_Salem	mack	male
McilvainKristen	kris	male
Ayee_Its_Trae	david	male
LilBigTrouble	mara	female
TonyMiano	tony	male
ADClarkDuncan	clark	male
jackorooney	john	male
abesana5	abel	male
jasonklinman	jason	male
segiddins	samuel	male
philmoffett	phil	male
mnsearchers	brian	male
USAFsalvas	spencer	male
HTOTHEIZZZOO	michael	male
mashley1995	mark	male
emventura01	kitty	female
kldrauhlyoutube	vanessa	female
Jasong322	jason	male
Gregorycrabill	greg	male
functionalabc	anne	female
andyjamesberry	andy	male
Invitrodan	dan	male
ginij2035	gina	female
Shaye1Smith	thomas	male
K8lynnDover	kate	female
yobanymendoza56	rene	male
pakawa_	paige	female
tylerlehner	tyler	male
penisstagegirl	marta	female
jwendler123	jason	male
laurenhoff96	lauren	female
HouserCommaJake	jake	male
LeanneComedy	leanne	female
koretofft	tanner	male
2BitSpecialist	aaron	male
cyrilthewolf	cyril	male
jasmiinejazzy	jasmine	female
Timmy2cups	goldie	female
whopper45	wayne	male
zach216	zachary	male
southshield	travis	male
PearlHurst	pearl	female
FNFTNValley	ned	male
C_Schachel	charlie	male
samesfandiari	sam	male
aleroinc	rob	male
PeralesEfrain	efrain	male
Martinez_Hilary	hilary	female
christineoubre3	christine	female
n4trqjedi	arthur	male
bentleybetch	katie	female
Ted_W	ted	male
michylove20	michelle	female
chriscracklePOP	chris	male
eigross7	june	female
bbutera	brian	male
beautyandthebay	crystal	female
King_Albert12	albert	male
clancasterr	chris	male
ahillery23	andrea	female
courtfritts	courtney	female
amyfarahdugan	amy	female
Jami_C	jami	female
kkoquinn	katie	female
DarcyHocker1	darcy	female
t0t4lcl4rity	shannon	female
TaylorLindberg	taylor	male
Ska_373	seth	male
MikeHellaJordan	michael	male
Stars_N_Bars2	john	male
mike9wood	michael	male
tyocelot	wendy	female
RossHudgens	ross	male
mikedady	michael	male
Chrisstoopheer	christopher	male
Sgt1439	jeff	male
bschram96	ben	male
Destinysma	lisa	female
BrianCrouch	brian	male
JasonLawrence14	jay	male
_Jorcee	valerie	female
LindziMarie04	lindsey	female
oafaz	andres	male
DaTrapKing	roman	male
ACielinski	adam	male
MonmouthWeather	john	male
breeboo_98	sabrina	female
ihatereginab	regina	female
BertoBMusic	alberto	male
batuka031870	carlo	male
b_mullaney	elizabeth	female
cabbage_Sam	sam	male
lindseyhoma97	lindsey	female
beelo92	bianca	female
Jesse_Horne	jesse	male
kristanichols98	krista	female
ChanceTaylor2	chance	male
Rebexico	rebecca	female
lindseybhawkins	lindsey	female
Limeylizzie	elizabeth	female
d0wninunderland	candice	female
kendraamichelee	kendra	female
DrammaOne	andy	male
chelsea__ellen	chelsea	female
brandiftkam	brandi	female
conssr	consuelo	female
512b0c1173c84f9	ana	female
Emilaaaay1998	emily	female
isabellongoria_	isabel	female
jordanashleyy14	jordan	male
Law1Gloria	gloria	female
LlmNicole	nicole	female
KellyontheLink	kelly	female
lhoff526	luke	male
beegee6868	amanda	female
natalia625	natalie	female
_Raquuuel	raquel	female
CharlesTam	charles	male
Ev_Hoov7	evan	male
number5__	nigel	male
_BlackHawkDown	lucas	male
TDuke7	terry	male
kmbrlywst	kimberly	female
5b9ae5205c7b4dd	dean	male
ivq_xoxo	irma	female
j_gilla5	jasmine	female
offlede	andrew	male
bakercorey22	corey	male
SofiaSanMiguel	sofia	female
AllBri_	simone	female
boyofparadise	fabian	male
Charge112	charles	male
ADonde3	alex	male
EdMasley	ed	male
yungxpaul	paul	male
seiko_ohms	sarah	female
deborahowens	deborah	female
mirandaadoll	miranda	female
claireorourkee	claire	female
miguelbarreto97	miguel	male
jimmyTMboswell	james	male
ValerieRosen	valerie	female
GradyNewsource	grady	male
lilwayndy_	wendy	female
saramarsden	sara	female
DeSouza_03	mark	male
tonybalogna	tony	male
NicoleSpector	nicole	female
AnthonyRaposa	anthony	male
OLenhard	olivia	female
LeeVogler	lee	male
AngieB500	angela	female
drewr	drew	male
jamihighroller	jamie	female
td8079	travis	male
yungyelllllllla	allie	female
GynoStar	rebecca	female
manduh_liz	amanda	female
aznole44	matt	male
alexistheresaa	alexis	female
_lareinasam	samantha	female
LambdasBuffalo	danny	male
kylthms	kyle	male
Dewbag	dewey	male
Alexis_5SOS_1D	alexis	female
whoolia	julia	female
okayyyemily	emily	female
AustinPrime	austin	male
jmreardonn	hugh	male
andrew_cary5	andrew	male
GregorySManess	gregory	male
StormTrackerWX	douglas	male
KentuckyBlacc	derek	male
bridgetcatalano	bridget	female
NorthwestNick	nick	male
JohnBarinaga	john	male
Jhaugen20	justin	male
senyorreporter	tim	male
jenna_chambers2	jenny	female
JoeBroering	joe	male
chelseacoop1964	chelsea	female
TheDudekAbides	duane	male
dylan27w	dylan	male
senior	robin	female
DoctorLou72	louis	male
Ewwjr53	eugene	male
RonaldMiller69	ronald	male
kararust	kara	female
wishesofjacob	chad	male
pattyaerobatics	patty	female
sarahnferris	sarah	female
TaraSob	tara	female
BWylene	brooke	female
cole_mackey3	cole	male
stxrgiu	anthony	male
AaronEPotter	aaron	male
samedelen	sam	male
lovexbrookie__	brooke	female
nickicheng	nicole	female
Desidutch	desiree	female
Unloadaa_Lewis	vince	male
KaylaCrafton_	kayla	female
ITSoFRISCHial	jeremy	male
ClaudiaStrick97	claudia	female
redtookmoney	julio	male
jen_rasmussen	jenna	female
taylor_nacci	taylor	male
abbymedlock	abby	female
singnrn	eileen	female
cramberriez	amber	female
captainroatey	robert	male
AlexEdmisson	alex	male
ringeltg	teresa	female
RachelA_Adler	rachel	female
goobeara	beth	female
malcolmlovesrih	malcolm	male
adriennemoorman	adrienne	female
mohammed_shamma	mohammed	male
TrillyxNelson	joshua	male
Ringham7	richard	male
BunchesofJohnny	john	male
KathyCoFlowerVT	kathy	female
emmaasteele	emma	female
LaFabiyua	queen	female
jilliaansaso	jillian	female
CJDavis_13	clayton	male
AlyssaDazzi	alyssa	female
jas83j	jason	male
krueger199710	tyler	male
MarianaESanchez	mariana	female
HaaseAmber	amber	female
bankre	kevin	male
ellenhutter	nanette	female
thedjpastor	kelly	female
CaroleGilman	carole	female
DRFGrening	david	male
Cynthinee	cynthia	female
KeeleyFox29	steve	male
RikDaddy	ricky	male
katherinetrice	katherine	female
c3po94	colin	male
tycolby	ty	male
PaigeRawl	paige	female
_StephyMarie	stephanie	female
TortillaVerde	james	male
w_mrwes14	john	male
fredweenie	freddy	male
abbysharpeee	abby	female
christiwrites_	christian	male
PaulAmado_	paul	male
ByronBucao	byron	male
SofiaRochin	sofia	female
DE_rek_XC	derek	male
hashtagjanine	janine	female
johnbheaton	john	male
stephenrhymer	stephen	male
WesDotJay	mike	male
kaylaposey	kayla	female
jatashiam	april	female
maneec	chris	male
siouxi31	susan	female
LuhhSarah	sarah	female
mercator88	andrew	male
DianaEscobar94	diana	female
_brendagill	brenda	female
par_k_er	parker	male
agustinsoto21	agustin	male
cvarsalona	carol	female
_DB17	david	male
nicholeeury	nichole	female
tonyparker32	tony	male
Super_Villain98	young	male
_teineaulelei	april	female
GCM5198	grant	male
MONTYSS305	monty	male
SeanHollyman	sean	male
brittanyylor	brittany	female
jheanneaiko	jeanne	female
marevoyant	mary	female
DatKiddAngel	marc	male
KathrynUTOLEDO	kathryn	female
mikemonsterx	mike	male
CatherineYaun	catherine	female
PayUp45	eddie	male
pablochicon	matthew	male
nmastro13	nicole	female
domesticaffairs	melissa	female
mentalboy2281	nick	male
AaronMadar	aaron	male
mythical_gabz	gabrielle	female
stimppp	stephanie	female
originalsin06	amanda	female
saltoofly89	sally	female
sarahftgrier	chad	male
a_ndynguyen	andy	male
natalieperez12	natalie	female
corpeybaggins	corey	male
ccbama	cary	male
HurricaneHowie2	howard	male
purtypatty	patrick	male
oliviaripke	olivia	female
That_Girl_Vic	queen	female
BuchmanB	brittany	female
switch2756	mark	male
kelseykcopeland	kelsey	female
Brit_t1	brittany	female
tayyy_marx	taylor	male
Holliday7Linda	linda	female
mortgageconsult	pam	female
AustinScott10	austin	male
LimeypamPamela	pamela	female
LadianJessica	jessica	female
krismadu	kris	male
Ms_Monroy27	caroline	female
KennyPatinar	kenneth	male
jakereidd2	jake	male
erikarw1	erika	female
thebeardofzeus_	roy	male
serenaaaboo	serena	female
princessjesikuh	jessica	female
kirsten_ritch	kirsten	female
TlLance	lance	male
AmbuhhNicole	amber	female
LWillsonn	elizabeth	female
AbercrombieTrey	trey	male
idjcastro	gerardo	male
MattMillerLPC	matt	male
Scuba_Scotty	scotty	male
leanneseeger	leanne	female
e_sparxx	emilio	male
_adriana_1202	adriana	female
EMT_Jdot	jose	male
tarvisphillip	travis	male
JMHaircut	jack	male
rvircks12	rachel	female
castingshadowss	marlene	female
knovak832_novak	kathleen	female
caitlinbernier	caitlin	female
HaleyLinam	haley	female
SamSleevuh	sam	male
christinaxoxo14	christina	female
monicaely69	monica	female
DTMetz	david	male
nailsbyray	rachel	female
robperine1	robert	male
LanaDelReyMe	anna	female
HartABrian	brian	male
lyncross29	lynda	female
smileyburns	katie	female
israelquiroz93	prince	male
BeamNcoke	vern	male
KennyBuyers	kenny	male
RStarovich	rebecca	female
JamesEBriggs	james	male
AdrisArmendariz	adriana	female
alanmoy113	alan	male
chrisgonyea	chris	male
DrFuegoPhD	sebastian	male
hmfergie18	hannah	female
JimJarmuschHair	andrew	male
Jedi_Saiyan_3	alex	male
HawksAffair	michael	male
_dreslinks	phillip	male
BiHiRiverOfLife	bill	male
west_spliff	carlo	male
hrlyhny1969	donna	female
GiuseppeGottiJr	giovanni	male
TheKenGent	josh	male
fockerbro	sam	male
stormgaming759	michael	male
sksnshh	mark	male
stacuhroo_	stacey	female
tayyx98	taylor	male
jo_maisey	jo	female
grantkettnerr	grant	male
AshleyBratton	ashley	female
random_mattyu	matt	male
angstkat	kate	female
IFGM08	ignacio	male
_May_gaucha	may	female
maryemmaaa	mary	female
CTrill214	isaiah	male
jpwrgirl	karen	female
xmarcsthoughtsx	marc	male
SandyKenyon7	sandy	female
paulzubrys	paul	male
kay_witz	kara	female
Nikkii_eMm	nicole	female
lindatoupin	linda	female
DramaDan21	jack	male
professormccabe	heather	female
jimmysmears15	jim	male
Ryan2434	ryan	male
lindseyclaflin	lindsey	female
_lordcarter	dorian	male
justinloosemore	justin	male
emanouks	alexis	female
davidmcgee881	david	male
jacobtrad11	jake	male
SBradley1972	scott	male
kaylaaamorann	kayla	female
awestk_	alexis	female
grant_merrill	grant	male
dps_coberly	devon	male
ACarnazola	andrew	male
bobbruer	bob	male
ltemme1993	laura	female
Jeremiah_Ray	jeremiah	male
meghansivakova	meghan	female
LaurieVass	laurie	female
BballWife4Life	morgan	male
AlanTonelson	alan	male
Twus12	tyler	male
bueno_anthony	tony	male
WillJam1	will	male
_christinaaaxox	christina	female
Ipwn4mom13	aaron	male
morganbeebe	morgan	male
samhamjambam	samuel	male
_ianferguson	ian	male
taylllor_d	taylor	male
JamalJJames	jamal	male
JonRyan9	jon	male
rynwlson	ryan	male
Muy_Macho_Nacho	erik	male
sarahmccluske2	sarah	female
AirstrikeRhino	ryan	male
helsthomas28	helen	female
FranchiseKrysis	kevin	male
frankmSounders	frank	male
ImChristiiann	christian	male
JimB_85	jim	male
JennEveEis	jennifer	female
ChelseaDerrigo	chelsea	female
emfergz	emma	female
SoccaPedro	pedro	male
Julliaaannnnnnn	julian	male
PrinceJaimes	eduardo	male
TheLoriRusso	lori	female
LydiaSimburger3	lydia	female
MoKnowsTwo	moses	male
TJPowell11	tanner	male
ortizmiguel31	mike	male
clydesglide	carla	female
Zor_	matthew	male
jcfmbost	john	male
aldelmage	amanda	female
_IVx0	ivy	female
OnlyImprobable	david	male
fagazar	brandon	male
dylanswarrior	rachel	female
SophiaPaulmier	sophia	female
morgan__munn	morgan	male
n_a_young	nathan	male
thomasgpadilla	thomas	male
LMCKatyCat4Life	logan	male
HEELStach	chris	male
Meswannjr	michael	male
jbc436	jacob	male
MaxwellDoctor	maxwell	male
gixxerguy89	todd	male
mcfryer	marcus	male
elisabethw10	elisabeth	female
A_JayLuck	jeff	male
BeccaNaka	rebecca	female
robobem	robert	male
PensfanRVA	john	male
amber0kristine	amber	female
cre8ive_juice	michael	male
MJBgetlikeme	mel	male
2313emily	emily	female
LittleMexico58	vincent	male
davidhoang	david	male
YBrammer	will	male
SoleGUM	johnny	male
SchaferAmanda	amanda	female
CurtLeeG	curtis	male
garrettsnyder22	garrett	male
KellyLoveducks7	kelly	female
yareeet_24	sharon	female
borchard929	brad	male
kristaspring_	krista	female
AwhiteBEANER	andrew	male
TheMitchPerkins	mitch	male
JoeKane52	joe	male
Advocate4Oils	bonita	female
nicollesntcrz	nicole	female
ssony711	sandy	female
tmaepiccolo	mae	female
Harrison_M3	harrison	male
slaterj4245	joseph	male
notabbygraf	abby	female
Fearlesslady819	nicole	female
BGooseOnDaLoose	ben	male
ScottGarg	scott	male
erickend	erick	male
robert_lee_reed	robert	male
Michelley19	michelle	female
The_King_Terry	travis	male
ezzym4	esmeralda	female
DrizzyDPope	daniel	male
BIGeffingRED	shannon	female
gina_reis	gina	female
torres_jayyy	jonathan	male
BodyworkByJon	jon	male
ballislifecj121	sterling	male
e___________m	emily	female
DanaLettl	dana	female
Its_Nick_Nasty	nick	male
LaurenKerbyy	lauren	female
DjSquintzz	sam	male
tcap46	patricia	female
JPBarlow	john	male
CJaz11b	rocky	male
TylerLennoxBush	tyler	male
Brandon_Geee	brandon	male
TravisEanes	travis	male
johnsonmode	elijah	male
rostrander13	ryan	male
JohnNoon	john	male
idioxsyncratic	julie	female
leaahbrown	leah	female
bethstey	queen	female
TravelWithMarie	marie	female
jeremystanley	jeremy	male
krombie	melissa	female
angieg8771	angela	female
hargo65	mike	male
samshieldss	sam	male
HarryHowardddd	harry	male
DavidRexGosnell	david	male
EWAEmily	emily	female
RealDavidIsrael	david	male
givemebri	brianna	female
AhhhZOMBIE15	john	male
belc1429	amber	female
kristinNwagner	kristin	female
alexxashh	alex	male
_DannyDakdouk_	danny	male
SamViscardi	sam	male
C_d_Caddell	carl	male
_mkd_1222	mary	female
mandy__bo	mandy	female
DaRealMaizeRage	ty	male
ben_swinehart	ben	male
TenorLLC	matthew	male
Steve_Grad	steve	male
n_attend	mark	male
QuigRj	rory	male
k8lyngc	katelyn	female
henriquezme2	humberto	male
Christian_G15	christian	male
RonReardon	ron	male
ArnoldSmithPLLC	arnold	male
JustStormy	melissa	female
OVOLynn	brandon	male
cecil_lauren	lauren	female
claireec15	claire	female
feliciaacitta_	felicia	female
brandondotis	brandon	male
ohdearalexiss	alexis	female
MTCluse_	tyler	male
KarinByrne2	karin	female
missannajune	anna	female
Pure_Incognito	justin	male
mattperkins0	matt	male
sissy_cay13	sara	female
MartinHooper	martin	male
yomyatt	dave	male
JMichaels_	john	male
MLG_POLLUTE	joey	male
gucciavery	avery	male
memo_amber	amber	female
alyssa_warhol	alyssa	female
dtanner1865	danny	male
CoachSmFry	janice	female
babeIincoln	terra	female
Al3x_B3aSt	alexandria	female
MandyAspey	mandy	female
juanrodz17	juan	male
LifeOFa__Legend	young	male
The_Kaths_Meow	brooke	female
alexis_hussey52	alexis	female
KnightWolvesJE	jake	male
Sweezy_F_Baby	andrew	male
Lourdes54216708	lourdes	female
Philip_Brad22	phil	male
bwdds	brian	male
Uncle_Borris	benjamin	male
_OVOXO98	abe	male
thattherecorey	corey	male
mlswrrntkns	miles	male
itzdreamix	andy	male
jsaav10	julia	female
Jennyyyy_b	jenny	female
ccarolina__	carolina	female
ZyhailoKathryn	chi	male
sydflynn	sydney	male
lilayxoxo	liliana	female
McNurly	reed	male
Mgr1976Michael	michael	male
MDLasky	matt	male
AdamWaldron	adam	male
tylerkamei	johnny	male
ShelbyBelford	shelby	female
imfromatx	mike	male
Ceo_Mark23	charlie	male
sciara_mary	mary	female
RobOlsonFOX9	rob	male
shoppergirl21	christy	female
PaPaInness	jake	male
Janine_thequeen	janine	female
chasjoe	chuck	male
OfficialCarrie_	carrie	female
xoblanncaa	blanca	female
DavidfromOregon	david	male
Daveyy_Boyy99	david	male
Jesse294_	jesse	male
Dan_Laferriere	daniel	male
BobbSagett	jeff	male
queenmeggi	megan	female
AllenVWin	allen	male
HeirAPPARENT310	joey	male
Edwinbau	edwin	male
petepopkess	pete	male
beatstephen	stephen	male
muhshellsanigga	michelle	female
savannaheveguev	savannah	female
GoKaraGO	kara	female
GiraffesGoMeow	queen	female
idktiffany_	tiffany	female
KYANOVCYANIDE	audrey	female
youvegotmindy	mindy	female
robmonroe	rob	male
r0ccafl0cka	gabrielle	female
Saxton18	dillon	male
aleserrano10	alejandro	male
VATBIDoc	joel	male
SydneyRichwine	sydney	male
atnum	christopher	male
kendalllane263	kendall	male
LeeMarrow21	lee	male
KristenSicilian	kristen	female
melissacampos28	mel	male
Dbarg8	derek	male
TayTaylor24	taylor	male
_caPICCINo	john	male
IvyIdzakovich	ivy	female
Jaygordon_1981	jason	male
GoMikedesim	michael	male
BallerT_3	tony	male
Qestep8	quincy	male
brooke_chante_	brooke	female
__Reeves__	casey	male
0d2996ecd98342a	jerry	male
LongLive_David	dave	male
AMiller133	amanda	female
SamHamme94	sam	male
sunheiights	kayla	female
BillyAndersonYo	billy	male
crazy4court	courtney	female
kristophrenia	kristy	female
tedsmoot	ted	male
cdulaney96	christian	male
Emerson_Careers	emerson	male
mturner2871	maria	female
JenJenHoney101	jennifer	female
DeloresAHardin	delores	female
gratajik	greg	male
rachel_rodgers_	rachel	female
kentspeakman	kent	male
DarrellBurks	darrell	male
MarryMeMiller	hannah	female
marlaramires	marla	female
Mohd_RMA	mohammed	male
__Caroline96	caroline	female
CalebKnaak	caleb	male
bucketloveee	jessica	female
laurenedzyyy	lauren	female
boredasgeorge	george	male
loanextdoor	april	female
ScottCarnahan1	scott	male
TheKelseyGrimm	kelsey	female
lizkineke	liz	female
sgelpke	sally	female
Jagrmeister	johnny	male
lexiquin	natalie	female
RossKohnstam1	ross	male
Burradley	brad	male
RasachiRasachi	clifford	male
GBW2421	brent	male
jamiewang	jamie	female
RFEthan148	ethan	male
pamelafox	pamela	female
LeonardLiesJr	leonard	male
meghancolabufo	meghan	female
BornToRunCoach	eric	male
BeyHiveDeluxe	nathan	male
Tay3685	taylor	male
AhmedFullMD	ahmed	male
samantha_xoxo__	samantha	female
mattrubin	matt	male
_tannercook	tanner	male
shelbyduggan	shelby	female
AngelaOua	angela	female
lyss198	alyssa	female
HollyLudvigsen	holly	female
sobry14	oscar	male
Davefweber	dave	male
timothy_roscoe	timothy	male
suzette_jimenez	suzette	female
babybootcampin	kara	female
ashleyk_blondie	ashley	female
alan_ramos__	alan	male
idolxfactor1	al	male
DrEFontaine	emmanuel	male
KaylaRay817	kayla	female
lmkrabbenhoft	lindsey	female
__yakuza	ashley	female
Danny_TMT	danny	male
Lauraromamo	laura	female
Krysyyy	krystal	female
taylorpsoares	taylor	male
ahogan92	austin	male
macke_nziedavis	mack	male
jordanschweyher	jordan	male
DanielleDinelli	danielle	female
ainnes84	andrew	male
cdub911	chris	male
MJ_Bond	melanie	female
PraisedCOD	harrison	male
Bharty20	blake	male
bttsjm	jessica	female
TheWilloby97	megan	female
RandallGoldman	randall	male
likecroft	lara	female
sarahthomas512	sarah	female
naeray13	crystal	female
ShannonAReid	shannon	female
Cgards42	cole	male
Mmahone	michele	female
cynthiaacosta96	cynthia	female
maggie_st89	maggie	female
JKs808girl	kimberly	female
LukyClover	amanda	female
los_MONEY10	carlos	male
Laurkohl7	lauren	female
Notorious_Kevo	kevin	male
Lanster77	adam	male
Cilla001	priscilla	female
PhickOTM	megan	female
ScottyF502	scott	male
autumndawndiaz	autumn	female
jayhinz	jamie	female
djouuuuh	justine	female
InWeWeTrust	wesley	male
T_Sully44	tyler	male
seriouslynashh	chad	male
Jackkhoran	jack	male
RobertAmaro1	robert	male
riffinator	thomas	male
AimeeDobos_2	aimee	female
JoeyParmenter	joey	male
marcpolitik	marco	male
gracefisher__	grace	female
Beer_Bongs	dustin	male
BloominIdiot	petra	female
RonFromLasVegas	ron	male
itsmikevyall	mike	male
DuaneFromNJ	duane	male
lisaryman	lisa	female
DylanYost17	dylan	male
TayBridgeee	taylor	male
taynoland	taylor	male
Tommy__TomTom	tommy	male
Felix__Jr	felix	male
MMillaire_MM	michel	male
TheSimbaPikachu	byron	male
ktking404	katie	female
carriecourogen	carrie	female
Bluegenius	beth	female
obrienspool	rob	male
CACballinout223	corey	male
perrodin	jonathan	male
lisaparticelli	lisa	female
pmurray_1	patrick	male
terribmusic	terri	female
lady_brimm	kim	female
Tattoozbyrico	rico	male
diego_deutsch	diego	male
deslivas	desiree	female
TheLederMAN	jason	male
crazzeeedave	dave	male
ConsiderESO	eric	male
Kellie737	kellie	female
IAmNickFloyd	nick	male
hannahveary19	hannah	female
Amandasworld__	amanda	female
IngridFajardoo	ingrid	female
kristinaaleann	kirk	male
JudithAdanma	judith	female
jessiehinton	jessica	female
TheCaseyEverett	casey	male
BruceClifford	bruce	male
SarahJoDixon	sarah	female
DuhZam	danielle	female
DPNJ	dan	male
K8Joh	kate	female
MrPreTechEd	johnathan	male
Anisaax33	queen	female
davidsiders	david	male
kellycxo	kelly	female
Beer_craft	keith	male
alexmccarthy429	alex	male
JLowHP12	jason	male
JEFFBM	jeff	male
deziel770	david	male
SUGARBBBERRYY	sara	female
Jordansince89	amy	female
tiffys1983	tiffany	female
dreww_95	andrew	male
jakegrotz19	jake	male
TheOceanLights_	jack	male
chrisbumpus97	chris	male
susanlitelerner	susan	female
MeanGreenDean22	dean	male
kingofthebutt	jillian	female
JenniferADewey	jennifer	female
mattcrandall	matthew	male
CamilleCantu	camille	female
Itzz_Me_Ana	ana	female
SammArellano	samantha	female
victorlpz_	victor	male
justwaitonit17	june	female
chris_morgan42	christopher	male
JeevesSF	bradford	male
Mona062306	mona	female
jaclyn_kweder	jaclyn	female
KingofKingONE	son	male
BenRuffolo	ben	male
Kase_yo	kasey	female
gypsymommatay11	taylor	male
Natalieee5SOS	natalie	female
JocelynGrove	jocelyn	female
realcroney	alexander	male
davidsldarriaga	david	male
benoitbandon	brandon	male
D_Gaffan	daniel	male
MaryNilsen	mary	female
MrsMatched	andrea	female
austyhaas	austin	male
gracekennardd	grace	female
TessaBradbury	tessa	female
racheltutnick	rachel	female
divinelydevelop	greta	female
BethanyElkhorn	bethany	female
crh2018	christina	female
captainalex11	alex	male
carolinaguerram	carolina	female
joxman	jason	male
malicegeres	hallie	female
vnesssssss	queen	female
JRsList	joseph	male
Ashcash_9	ashley	female
emilycronin18	emily	female
Christian2Nice	christian	male
TNCoverGirl	sara	female
mxrggan	morgan	male
Rolotweet21	rolando	male
Jason_Urbanski	jason	male
iflyatnight	laura	female
ryanpathughes	ryan	male
gabbysamplee	april	female
_hernandezmaria	maria	female
lorraine__xoxo	lorraine	female
SeeYaLoveYaBye	antoinette	female
freddylikeapple	freddy	male
oddballextreme	shirley	female
stephanie_lebel	stephanie	female
Stefanie84	stefanie	female
_samtherealest	samantha	female
mojomonkey_12	jeremy	male
Melody_Teal16	melody	female
TuElite	charles	male
mescotto	kelly	female
RuesingChris	chris	male
RHSportsGuy	tom	male
jhamby	jake	male
DrSamNaismith	sam	male
samlan_	sammie	male
BrandtRosie	rosie	female
ArielMediaKC	ariel	male
Adrianaadelao	adriana	female
aye_quintanilla	alicia	female
carlies89	carla	female
ray4pay	raymond	male
damianmreid	damian	male
maggzzieee	maggie	female
Kashdra	sue	female
DanielleD024	danielle	female
Blakeologyy	blake	male
clairebear618	claire	female
StudioJPro	joe	male
emmaagreenn_	emma	female
IloveJrb15	jasmine	female
JBuccola	john	male
DangitsJudy	judy	female
Trevor_pittman	trevor	male
AnimeKeating	adrian	male
PaartiaI	nick	male
lukesimpson1998	luke	male
AudreyA93	audrey	female
MalloryDuane	mallory	female
problemattick	michelle	female
karonmoser	kelsey	female
omg_its_rickk	rico	male
TimJGardner	tim	male
ssarahjessica	sarah	female
MariavMP89	maria	female
Ahmad___Jordan	ahmad	male
h_0ray	lloyd	male
MDRHotel	marina	female
Alex__McIntire	alex	male
Burt_Carter	burt	male
JoeyHillyer	joey	male
Eric_G96	eric	male
allforangela	angela	female
RobynMarie15	robyn	female
AmberAudra	amber	female
hi_em	emily	female
crazycarlisrite	nolan	male
bobbyo1967	bobby	male
jasmine_294	jasmine	female
slawn34	steve	male
virgboecker	virginia	female
victoriafricky9	victoria	female
Bittersweetsol	mayra	female
karababesss	kara	female
Kyllick	kyle	male
jamespauldillon	paul	male
Angel_Bads	angel	male
dare_to_LIV	olivia	female
kathyparman	kathy	female
NaomiTropman19	naomi	female
Olivia__hope_	olivia	female
acob94	aubrey	male
ShmittyluvsSNX	lauren	female
johnlopez404	april	female
theorangehead	jenny	female
Bfernandez996	brandon	male
katie_story	katie	female
2Leahrae	rae	female
Kayflemister	kayla	female
brrrryyyan	bryan	male
RLfavgirl70	annie	female
chenthusiast	daniel	male
Jimmies0Rustled	ivan	male
CC_Sissy	beth	female
AnnBedge	ann	female
TristanMcClone	tristan	male
JennaDuchek	jenna	female
ckinger13	chris	male
chrisbirchmore	chris	male
chrristine15	christine	female
cheekz931	anita	female
alcefaly	audrey	female
ClintTill	clint	male
Larry_G_77	larry	male
unLEVINed_bread	jason	male
Pompiliyooo	steve	male
That1girlalissa	alissa	female
Leroy_Waklatsi	leroy	male
MelissaMesku	melissa	female
Rubyjsme	esmeralda	female
bethtrains4life	beth	female
cecechappelle	celia	female
BryanFolstad	bryan	male
imgoingreene	stephen	male
k_elizabeth04	kelsey	female
e_j_hartman	eric	male
c_snell	charles	male
JustinHMGraci	justin	male
MozzareIIaStix	drew	male
mitchclay1970	mitch	male
sonoble	steven	male
Tagg_YourIt	dustin	male
mzbubblzbreezy	rae	female
sarah___joy	sarah	female
JakeFrye805	jake	male
chelsearyn	chelsea	female
PromoRach	rachel	female
tbesse29	tristan	male
loganator_12	logan	male
freespeak3	jan	female
kelly111amy	kelly	female
PAULYLB	tom	male
RyanCprods	ryan	male
DHughesNYC	david	male
welshcanalroad	john	male
emma_pellegrini	emma	female
ThePaulDorsey	paul	male
oliviadunkleee	olivia	female
stephy_2010_h	stephanie	female
dietmountandrew	andrew	male
danieldowns	daniel	male
timothyvnguyen	timmy	male
lauren_bentley_	lauren	female
mediaryno42	ryan	male
krclose	kristin	female
Uniqemoniqe	monica	female
_brookepetersen	brooke	female
crossfit_mama	sarah	female
caattii_	catalina	female
mmichelleeeeee1	michelle	female
troylilly_	troy	male
livbrock_	olivia	female
edchavez1	edwin	male
SabrinaSigns	sabrina	female
edhamiltontx	ed	male
maxthebody	max	male
heatherdhansen	heather	female
cwallsbeauty	candace	female
JaredLichtin	jared	male
ChristianSaad	christian	male
TheFlirtyVegan	mavis	female
Drew_Review	drew	male
daktx2	daniel	male
ColinHClark	colin	male
Gobzilaa	jacob	male
Blackboy_edward	mari	female
Jaaay_Rage	jordan	male
JT_KELLEY21	jonathan	male
chris_bonnefond	christian	male
jimhatesyou	james	male
GlobalSpaGirl	judith	female
David_Shorr	david	male
kaithedoofus	jody	female
nemeth	andrew	male
emma_tufo	emma	female
STMSCK	steven	male
T_Olsen1	tyler	male
NickB925	nick	male
iClarkSuperman	clark	male
WesleyPiffer69	wesley	male
decurtisjv	valerie	female
BrettStolz	brett	male
kell_bell20	kelli	female
nickstocklin	nick	male
HannahDreer	hannah	female
marissa_sugrue	marissa	female
MAR10theSPARTAN	james	male
JoseyKenya	kenya	female
carolinekkay	caroline	female
_MichaelWerder_	michael	male
trinilee11	drew	male
ladytecniq	rebecca	female
KateMooreDesign	kate	female
junebiz	rafael	male
CarmenG20567332	carmen	female
Michannemitch	michele	female
kategertner	kate	female
jascastro92	jasmine	female
stevehaha	steve	male
JUICY_THE_DOG	jake	male
shelbyhope5	shelby	female
Jalemann	jorge	male
alyssajaraa	alyssa	female
SarahCroughwell	sarah	female
SteveSGoddard	steve	male
paulbtattoos	paul	male
avacad0e	ava	female
sarahnelson1123	sarah	female
Kevovo2	kevin	male
verabradleyjobs	vera	female
laaaashley	lauren	female
MerazCathy	cathy	female
28dd2cd7fcb143b	dorian	male
itss_antoniaa_	antonia	female
grant1magana	grant	male
Anthonysmp	anthony	male
uynairda	adrian	male
nmdmatt	matt	male
aguilar_jenifer	jenifer	female
JohnDOrtiz	john	male
LaurenRVA	lauren	female
breemahoney99	brianna	female
libbv	elizabeth	female
sadowski_mike	mike	male
IamJerrySuarez	jerry	male
ritzevollaer	maritza	female
wildcocaina	alexis	female
broooke_silva	brooke	female
qualitycash	chad	male
VaneCarmona	vanessa	female
djf123	derrick	male
DrDre1303	andres	male
TupacIsAlive69	evelyn	female
EntoMike	mike	male
Ceomindz	michael	male
v_jorgea	jorge	male
ohnoitsjanna	janna	female
MattJordanCuh	matt	male
The_Minge	robert	male
CarrieCornish	carrie	female
IcyG22	isaiah	male
anntoinettey_xo	antoinette	female
MaribelYartu	maribel	female
caitesellers	caitlin	female
_Itsmeolgaa	olga	female
AC__GOMEZ	anthony	male
BonnieRinker	bonnie	female
Its_T_Worrell	tyler	male
JasmineSMurray	jasmine	female
Iz77	israel	male
formerselves	laura	female
tahirajh	heidi	female
jburk3r	justin	male
robertdly	bob	male
SAMM_babyx3	samantha	female
arnoldkilci	arnold	male
Ssm______	shannon	female
harlemsmover	marvin	male
LanaTheStylist	lana	female
okerrigan65	kevin	male
darkmang_25	jon	male
wadiMANIAC	anna	female
curtis_cynthia	cynthia	female
ellen19official	ellen	female
mortigitempo	jonathan	male
LexiiiiT	alexandria	female
Lukesteezymoney	luke	male
Eduardo_MtzCast	eduardo	male
elizabethivyj	elizabeth	female
WillStack3	will	male
metallica4390	john	male
dyobekaj	jake	male
KMILL_10	kyle	male
BeauPhilip	beau	male
Lacey_24_nicole	lacey	female
GiLovesDanny	gilbert	male
JeremyMarzka	jeremy	male
sammantha_paige	samantha	female
carly_howes	carly	female
mhmahoney	melissa	female
RichartMaria	maria	female
scdermer4	shelby	female
debrajlarson	debra	female
Sarah_Skyline34	sarah	female
Alvinstafford	alvin	male
LizMilewicz	liz	female
DammeTrippy	van	male
erinclementi	erin	female
alex_carlosv	alex	male
baee_flores_24	rosario	female
ssavvy_stittss	savannah	female
Overcomer1993	sean	male
KrisHino	kristina	female
LFriedman_Lima	lindsay	female
jorge_ornelas24	jorge	male
Reichy18	emily	female
JarDawg1	quinn	male
vazquez_martin1	martin	male
BillyAshJR	billy	male
SydWinks	sydney	male
DubSteph_Chef13	stephen	male
katie_stuller	katie	female
THColinS	colin	male
EMGiosia	elizabeth	female
anna_sager	anna	female
blane9171	bill	male
JFHdzP	fidel	male
TiNA_RiCE17	christina	female
Zee_Gagliardi13	isabella	female
LaurensKids	lauren	female
beeeshayyy	brady	male
Choops34	rob	male
RobLafary	rob	male
AllieReardon	allison	female
lilcags	amy	female
OJE_95	rob	male
ANaku122	alex	male
Itsjustjackk	jackson	male
codefriar	kevin	male
seshen	selena	female
RyanClarkDoyle	ryan	male
jeanettewatts71	jeanette	female
broookejune	brooke	female
largebill68	william	male
alexgodoy_5	alexander	male
SixStringz1718	jeremiah	male
cdirvine	christa	female
Robbie_keller_	robbie	male
scornwell12	stephen	male
nickbayside	nick	male
jadegally48	julie	female
karchambeault26	kayla	female
Breezy_37	brianna	female
jessicarpal	jessica	female
a1dagdagan3	colin	male
KimKingomez	kim	female
nolan_rob	rob	male
lisamsterling	lisa	female
SIEGEL_adam	adam	male
MicheIIeDickey	michelle	female
ANN_aconda	annie	female
LenaAntonacci	lena	female
neecolaaa13	nicole	female
CalvinR32racer	calvin	male
emilytakesrook	emily	female
Radistephanie	stephanie	female
NolanSellsOut	nolan	male
thomas_connell	thomas	male
a_cicciarelli_	anthony	male
niucoachcarey	rod	male
DarylStrodes	daryl	male
recordmanmike	mike	male
lunalyssaa	alyssa	female
RachelRaeMarti1	rachel	female
Cynteaahh	cynthia	female
RSangeleer	richard	male
luke_winkie	luke	male
megnichole_20	megan	female
C_Lewis94	chris	male
mikesmith8026	mike	male
Amanda_Spruill	amanda	female
taylorbrii	briana	female
xtinaaa21	christina	female
EMILYRUTHAYES	april	female
CvrlaAlba	carly	female
ItsAustinAllen	austin	male
WmaniaMichael	michael	male
_DRAFALSON	danielle	female
shortylawson	tony	male
_xvmcmxcvii	taylor	male
jasonk_93	jason	male
JulianArroyo_	julian	male
biancagimena	alyssa	female
Dixiecreamm	ryan	male
sihlefeld12	sarah	female
O_Dawggggg	olivia	female
ajohnmoore	john	male
KevMoTbone	kevin	male
heatherianuale	heather	female
FelipePineda_	jake	male
VANCEATHOMPSON	vance	male
TerriA_D	terri	female
Krewell	kevin	male
r_benjjjjj	robin	female
kb0526	kevin	male
TheHervey	collin	male
katiesiegfried	kate	female
tayg95	taylor	male
KelleyMcNally	kelley	female
Abbyporter12455	abby	female
jenn26turpin	jennifer	female
sullivann18	tyler	male
Partyof3blog	alison	female
jake_gorbe	jake	male
Dclift2007	daniel	male
janellenye	janelle	female
Ryan_Stock_	lucas	male
RobRyanDJ	rob	male
jahdoughboy	james	male
Amyhall2432	amy	female
moody_amanda	amanda	female
mikey_maffucci	michael	male
oG_killuminatix	eduardo	male
FrozenStupid	john	male
oliviaoz12	olivia	female
amandasheirbon	amanda	female
McMurrray	david	male
b3rt31	robert	male
conradoconnell	conrad	male
_KatelynRebekah	katelyn	female
NPiazzola_27	nick	male
jessspelletier	jessie	female
susanspuhler	susan	female
thariddler	ramon	male
Bwilly94	brian	male
now_luCY_me	lucy	female
mexicankid_98	edgar	male
Barryphotog3	barry	male
nycsonny	hank	male
Rennntyler	lauren	female
ricdiculous20	ricardo	male
juliaaa131	julia	female
JordanEmsley	jordan	male
bkrocks29	brendan	male
jacobrussell	jacob	male
Axeliira	megan	female
lorrieangelia	lorrie	female
brookemartin11	brooke	female
AngelinaAbbate	angelina	female
heartfan90	brittany	female
maxelman	max	male
laurencroft_	lauren	female
acuransxfan	matt	male
4perf35	craig	male
angelaamontalbo	angela	female
paigeplease3	paige	female
danieltillie	dan	male
joelalucas	joel	male
britttheron	brittany	female
ashleydavis_95	ashley	female
victoriaxlafata	victoria	female
mwiz_over_texas	matthew	male
AndreaJnks	andrea	female
fantethecreator	john	male
Lauvai_I	ian	male
murphyclairee	claire	female
padrefinn	clayton	male
JennyEnright2	jennifer	female
_westrife	andrew	male
jaylaspooner	jay	male
benchau	ben	male
tfer7	tony	male
honeybunn267	stewart	male
40ozforte	pete	male
bonniecypher23	bonnie	female
dwyercd	christopher	male
MonaFigueroauh	mona	female
kylesmokecoke26	kyle	male
TimBaase	tim	male
lindsrichoeee	lindsey	female
AustinBurbage	austin	male
RachelEhnert	rachel	female
muchtyler	tyler	male
CamaroWRX	karen	female
McLovinn_77	shannon	female
_taylorganggg	lauren	female
bensonjl84	james	male
MarcoSav93	marco	male
velazquez_emily	emily	female
slslater	stephanie	female
Shawww9	toby	male
dhepburn	david	male
wyatt_mml	wyatt	male
J_Anderson_44	james	male
LearDreams	queen	female
Buddha6883	david	male
DolleyCamon	damon	male
chasecross98	chase	male
lil_bill_v	billy	male
XHaylenx	lon	male
ana_furtado	ana	female
GI_Jolt815	eric	male
luckyginnie	virginia	female
jessdoit82	jessica	female
Evan_Mullen	evan	male
Riverrat_143	haley	female
BrianGoudsward	brian	male
andrean1522	andy	male
_erin_xoxo32	erin	female
Patriciaaaaa21	patty	female
PeaceS33ker	jose	male
bella12chaparra	marvin	male
JessStumpf	jessica	female
LiveLoveJohn	john	male
ColeFoxxy	cole	male
